"player_id","player_nm","mp","poss","pts","diff","poss2","pts2","poss3","pts3","possft","ptsft","poss2_rim","pts2_rim","poss2_other","pts2_other","tot_fta"
"a/abrinal01","Alex Abrines",1134,310,352,42,69,62,221,252,20,38,37,44,32,18,46
"a/acyqu01","Quincy Acy",1359,394,411,17,73,56,292,306,29,49,42,42,31,14,60
"a/adamsst01","Steven Adams",2487,837,1056,219,710,896,2,0,125,160,504,694,206,202,287
"a/adebaba01","Bam Adebayo",1368,420,477,57,333,348,7,0,80,129,212,272,121,76,179
"a/afflaar01","Arron Afflalo",682,174,179,5,92,76,70,81,12,22,15,22,77,54,26
"a/aldrila01","LaMarcus Aldridge",2509,1512,1724,212,1255,1320,92,81,165,323,370,544,885,776,399
"a/allenja01","Jarrett Allen",1441,465,588,123,381,456,16,18,68,114,265,370,116,86,147
"a/allenka01","Kadeem Allen",107,26,19,-7,11,12,11,0,4,7,7,8,4,4,9
"a/allento01","Tony Allen",273,101,103,2,79,80,12,12,10,11,60,68,19,12,21
"a/aminual01","Al-Farouq Aminu",2072,618,644,26,243,210,339,375,36,59,125,152,118,58,80
"a/anderju01","Justin Anderson",519,219,236,17,99,106,103,102,17,28,61,82,38,24,38
"a/anderky01","Kyle Anderson",1978,503,585,82,381,424,57,57,65,104,170,234,211,190,146
"a/anderry01","Ryan Anderson",1725,522,617,95,141,152,339,393,42,72,68,88,73,64,93
"a/antetgi01","Giannis Antetokounmpo",2756,1683,2014,331,1262,1398,140,129,281,487,636,962,626,436,641
"a/anthoca01","Carmelo Anthony",2501,1252,1255,3,695,606,474,507,83,142,141,160,554,446,193
"a/anunoog01","OG Anunoby",1481,372,438,66,149,180,197,219,26,39,122,170,27,10,62
"a/arcidry01","Ryan Arcidiacono",304,44,48,4,10,16,31,27,3,5,4,8,6,8,6
"a/arizatr01","Trevor Ariza",2269,685,778,93,189,196,462,510,34,72,143,182,46,14,89
"a/arthuda01","Darrell Arthur",141,48,54,6,24,28,23,24,1,2,6,12,18,16,3
"a/artisja01","Jamel Artis",279,84,77,-7,50,46,29,24,5,7,12,16,38,30,12
"a/asikom01","Omer Asik",182,28,22,-6,22,18,0,0,6,4,18,14,4,4,13
"a/asikom01","Omer Asik",121,28,22,-6,22,18,0,0,6,4,18,14,4,4,13
"a/augusdj01","D.J. Augustin",1760,619,762,143,267,260,272,342,80,160,130,148,137,112,189
"b/babbilu01","Luke Babbitt",715,225,259,34,59,62,156,180,10,17,9,8,50,54,22
"b/babbilu01","Luke Babbitt",570,225,259,34,59,62,156,180,10,17,9,8,50,54,22
"b/babbilu01","Luke Babbitt",145,225,259,34,59,62,156,180,10,17,9,8,50,54,22
"b/bacondw01","Dwayne Bacon",713,203,175,-28,150,122,43,33,10,20,35,44,115,78,25
"b/bakerro01","Ron Baker",385,72,71,-1,26,18,33,33,13,20,17,16,9,2,27
"b/balllo01","Lonzo Ball",1780,594,528,-66,269,226,295,270,30,32,154,152,115,74,71
"b/bareajo01","J.J. Barea",1603,733,800,67,377,376,313,345,43,79,116,154,261,222,102
"b/barneha02","Harrison Barnes",2634,1339,1430,91,874,836,333,357,132,237,254,320,620,516,313
"b/bartowi01","Will Barton",2683,1124,1262,138,606,618,423,468,95,176,292,386,314,232,226
"b/batumni01","Nicolas Batum",1981,699,732,33,376,356,274,276,49,100,71,100,305,256,130
"b/bayleje01","Jerryd Bayless",925,282,307,25,116,110,146,162,20,35,44,60,72,50,44
"b/baynear01","Aron Baynes",1485,480,482,2,425,414,21,9,34,59,178,200,247,214,78
"b/bazemke01","Kent Bazemore",1789,762,835,73,402,352,274,324,86,159,153,186,249,166,201
"b/bealbr01","Bradley Beal",2977,1621,1829,208,954,968,530,597,137,264,305,416,649,552,369
"b/beaslma01","Malik Beasley",583,192,195,3,96,90,82,84,14,21,43,52,53,38,33
"b/beaslmi01","Michael Beasley",1653,869,976,107,719,750,86,102,64,124,265,358,454,392,159
"b/belinma01","Marco Belinelli",1947,828,960,132,368,376,395,447,65,137,96,128,272,248,163
"b/belinma01","Marco Belinelli",1210,828,960,132,368,376,395,447,65,137,96,128,272,248,163
"b/belinma01","Marco Belinelli",737,828,960,132,368,376,395,447,65,137,96,128,272,248,163
"b/belljo01","Jordan Bell",809,204,262,58,181,232,4,0,19,30,130,182,51,50,44
"b/bembrde01","DeAndre' Bembry",455,143,136,-7,98,84,30,33,15,19,64,66,34,18,33
"b/bendedr01","Dragan Bender",2069,507,531,24,162,138,322,354,23,39,87,100,75,38,51
"b/bertada01","Davis Bertans",1086,385,456,71,114,134,252,282,19,40,50,80,64,54,49
"b/beverpa01","Patrick Beverley",334,127,134,7,59,48,60,72,8,14,27,32,32,16,17
"b/birchkh01","Khem Birch",578,155,178,23,126,136,0,0,29,42,74,98,52,38,61
"b/birdja01","Jabari Bird",115,32,39,7,19,24,7,9,6,6,16,24,3,0,13
"b/biyombi01","Bismack Biyombo",1495,421,468,47,351,366,0,0,70,102,188,268,163,98,157
"b/bjeline01","Nemanja Bjelica",1371,391,454,63,187,190,183,228,21,36,97,128,90,62,45
"b/blackta01","Tarik Black",536,153,180,27,116,148,11,3,26,29,91,134,25,14,63
"b/blakean01","Antonio Blakeney",314,159,150,-9,91,76,52,45,16,29,24,30,67,46,39
"b/bledser01","Eric Bledsoe",2322,1127,1312,185,631,686,360,375,136,251,292,410,339,276,318
"b/bledser01","Eric Bledsoe",2239,1127,1312,185,631,686,360,375,136,251,292,410,339,276,318
"b/bogdabo01","Bogdan Bogdanovic",2175,815,902,87,443,430,329,387,43,85,111,136,332,294,119
"b/bogdabo02","Bojan Bogdanovic",2464,935,1128,193,466,498,386,465,83,165,223,282,243,216,205
"b/bogutan01","Andrew Bogut",216,26,36,10,25,34,0,0,1,2,18,28,7,6,2
"b/bookede01","Devin Booker",1865,1186,1329,143,670,616,384,441,132,272,190,232,480,384,329
"b/booketr01","Trevor Booker",1158,383,428,45,310,338,33,24,40,66,141,190,169,148,93
"b/booketr01","Trevor Booker",395,383,428,45,310,338,33,24,40,66,141,190,169,148,93
"b/booketr01","Trevor Booker",494,383,428,45,310,338,33,24,40,66,141,190,169,148,93
"b/booketr01","Trevor Booker",269,383,428,45,310,338,33,24,40,66,141,190,169,148,93
"b/bradlav01","Avery Bradley",1433,661,655,-6,422,368,203,225,36,62,142,170,280,198,82
"b/bradlav01","Avery Bradley",1268,661,655,-6,422,368,203,225,36,62,142,170,280,198,82
"b/bradlav01","Avery Bradley",165,661,655,-6,422,368,203,225,36,62,142,170,280,198,82
"b/breweco01","Corey Brewer",1208,358,380,22,206,222,110,93,42,65,161,194,45,28,90
"b/breweco01","Corey Brewer",694,358,380,22,206,222,110,93,42,65,161,194,45,28,90
"b/breweco01","Corey Brewer",514,358,380,22,206,222,110,93,42,65,161,194,45,28,90
"b/brogdma01","Malcolm Brogdon",1436,538,619,81,342,364,161,186,35,69,188,248,154,116,85
"b/brookaa01","Aaron Brooks",189,74,75,1,38,34,31,33,5,8,14,12,24,22,11
"b/brookdi01","Dillon Brooks",2350,842,895,53,508,492,264,282,70,121,212,276,296,216,166
"b/brookma01","MarShon Brooks",193,111,141,30,70,64,32,57,9,20,22,24,48,40,23
"b/brownbo02","Bobby Brown",115,59,50,-9,18,16,40,33,1,1,7,8,11,8,2
"b/brownja02","Jaylen Brown",2152,902,1017,115,496,504,306,363,100,150,286,356,210,148,233
"b/brownlo01","Lorenzo Brown",139,35,32,-3,22,24,12,6,1,2,3,4,19,20,2
"b/brownst02","Sterling Brown",776,216,217,1,114,100,91,96,11,21,55,58,59,42,24
"b/bullore01","Reggie Bullock",1732,568,698,130,265,284,281,375,22,39,108,160,157,124,49
"b/burketr01","Trey Burke",785,407,461,54,279,310,105,114,23,37,62,90,217,220,57
"b/burksal01","Alec Burks",1059,470,493,23,272,246,142,141,56,106,104,132,168,114,124
"b/butleji01","Jimmy Butler",2164,1098,1292,194,721,734,200,210,177,348,231,306,490,428,425
"b/buyckdw01","Dwight Buycks",427,218,215,-3,153,134,45,45,20,36,57,68,96,66,41
"c/cabocbr01","Bruno Caboclo",107,34,26,-8,14,12,17,9,3,5,5,6,9,6,6
"c/cabocbr01","Bruno Caboclo",100,34,26,-8,14,12,17,9,3,5,5,6,9,6,6
"c/caldejo01","Jose Calderon",914,198,254,56,88,96,97,135,13,23,33,44,55,52,30
"c/caldwke01","Kentavious Caldwell-Pope",2458,871,977,106,383,362,414,477,74,138,157,208,226,154,194
"c/canaais01","Isaiah Canaan",422,159,171,12,71,60,66,66,22,45,43,30,28,30,51
"c/canaais01","Isaiah Canaan",418,159,171,12,71,60,66,66,22,45,43,30,28,30,51
"c/capelca01","Clint Capela",2034,786,1026,240,675,882,1,0,110,144,542,778,133,104,257
"c/carrode01","DeMarre Carroll",2180,891,983,92,394,360,391,435,106,188,165,200,229,160,246
"c/cartevi01","Vince Carter",1026,298,313,15,118,114,165,171,15,28,48,56,70,58,37
"c/cartemi01","Michael Carter-Williams",835,271,239,-32,170,124,59,42,42,73,72,80,98,44,89
"c/carusal01","Alex Caruso",562,130,134,4,73,74,43,39,14,21,37,52,36,22,30
"c/casspom01","Omri Casspi",740,237,300,63,185,220,22,30,30,50,105,148,80,72,69
"c/caulewi01","Willie Cauley-Stein",2044,882,932,50,760,770,12,9,110,153,355,480,405,290,247
"c/cavanty01","Tyler Cavanaugh",518,161,182,21,63,70,89,96,9,16,41,48,22,22,21
"c/chalmma01","Mario Chalmers",1421,504,505,1,252,230,191,159,61,116,107,116,145,114,138
"c/chandty01","Tyson Chandler",1151,232,300,68,187,242,0,0,45,58,174,234,13,8,94
"c/chandwi01","Wilson Chandler",2346,682,738,56,386,386,246,264,50,88,176,234,210,152,114
"c/chrisma01","Marquese Chriss",1527,550,556,6,287,292,190,168,73,96,177,220,110,72,158
"c/clarkia01","Ian Clark",1455,515,539,24,300,320,195,186,20,33,75,102,225,218,59
"c/clarkjo01","Jordan Clarkson",1888,1024,1110,86,636,636,318,336,70,138,235,304,401,332,190
"c/clarkjo01","Jordan Clarkson",1256,1024,1110,86,636,636,318,336,70,138,235,304,401,332,190
"c/clarkjo01","Jordan Clarkson",632,1024,1110,86,636,636,318,336,70,138,235,304,401,332,190
"c/clevean01","Antonius Cleveland",123,24,23,-1,17,10,4,9,3,4,5,4,12,6,6
"c/collijo01","John Collins",1785,627,777,150,499,596,47,48,81,133,321,470,178,126,186
"c/colliza01","Zach Collins",1045,309,292,-17,177,160,113,105,19,27,77,96,100,64,42
"c/colliky01","Kyle Collinsworth",480,117,101,-16,82,68,17,12,18,21,35,34,47,34,40
"c/collida01","Darren Collison",2018,697,846,149,433,440,205,288,59,118,153,198,280,242,143
"c/conlemi01","Mike Conley",373,194,203,9,91,80,77,72,26,51,42,48,49,32,66
"c/connapa01","Pat Connaughton",1488,408,441,33,180,182,210,222,18,37,90,120,90,62,44
"c/cookqu01","Quinn Cook",740,263,312,49,148,152,104,138,11,22,46,52,102,100,25
"c/couside01","DeMarcus Cousins",1737,1033,1207,174,570,604,294,312,169,291,324,410,246,194,394
"c/covinro01","Robert Covington",2532,892,1008,116,286,284,549,609,57,115,149,198,137,86,136
"c/crabbal01","Allen Crabbe",2197,872,975,103,295,272,532,603,45,100,69,102,226,170,135
"c/craigto01","Torrey Craig",629,154,163,9,79,90,58,51,17,22,63,78,16,12,35
"c/crawfja01","Jamal Crawford",1653,783,817,34,429,408,314,312,40,97,43,58,386,350,113
"c/crowdja01","Jae Crowder",2090,740,773,33,330,322,341,330,69,121,171,226,159,96,148
"c/crowdja01","Jae Crowder",1346,740,773,33,330,322,341,330,69,121,171,226,159,96,148
"c/crowdja01","Jae Crowder",744,740,773,33,330,322,341,330,69,121,171,226,159,96,148
"c/cunnida01","Dante Cunningham",1562,386,417,31,196,212,168,174,22,31,121,156,75,56,52
"c/cunnida01","Dante Cunningham",1115,386,417,31,196,212,168,174,22,31,121,156,75,56,52
"c/cunnida01","Dante Cunningham",447,386,417,31,196,212,168,174,22,31,121,156,75,56,52
"c/curryst01","Stephen Curry",1631,987,1328,341,363,432,501,636,123,260,151,202,212,230,302
"d/danietr01","Troy Daniels",1622,600,700,100,117,98,458,549,25,53,28,24,89,74,64
"d/davisan02","Anthony Davis",2727,1715,2094,379,1300,1450,162,165,253,479,547,814,753,636,598
"d/davisde01","Deyonta Davis",943,291,360,69,265,322,0,0,26,38,154,232,111,90,57
"d/davised01","Ed Davis",1471,340,414,74,291,340,1,0,48,74,203,272,88,68,111
"d/dedmode01","Dewayne Dedmon",1542,509,617,108,336,400,141,150,32,67,134,208,202,192,86
"d/dekkesa01","Sam Dekker",883,284,303,19,199,236,60,30,25,37,146,200,53,36,56
"d/delanma01","Malcolm Delaney",1014,325,336,11,161,126,124,138,40,72,48,52,113,74,92
"d/dellama01","Matthew Dellavedova",712,161,159,-2,74,52,78,87,9,20,12,14,62,38,27
"d/derozde01","DeMar DeRozan",2711,1643,1809,166,1125,1112,287,267,231,430,281,380,844,732,559
"d/diallch01","Cheick Diallo",581,204,254,50,176,204,0,0,28,50,84,126,92,78,66
"d/dienggo01","Gorgui Dieng",1333,436,470,34,327,334,61,57,48,79,97,130,230,204,102
"d/dinwisp01","Spencer Dinwiddie",2306,950,1001,51,405,366,433,423,112,212,195,224,210,142,268
"d/dorsety01","Tyler Dorsey",974,411,405,-6,184,144,200,216,27,45,66,66,118,78,63
"d/dotsoda01","Damyean Dotson",474,169,182,13,93,100,68,66,8,16,34,40,59,60,23
"d/doylemi01","Milton Doyle",125,50,34,-16,24,18,23,12,3,4,9,10,15,8,8
"d/dragigo01","Goran Dragic",2378,1192,1290,98,775,746,300,333,117,211,289,364,486,382,271
"d/drumman01","Andre Drummond",2625,1064,1171,107,871,932,11,0,182,239,581,754,290,178,395
"d/dudleja01","Jared Dudley",686,138,152,14,42,38,80,87,16,27,23,28,19,10,35
"d/dunnkr01","Kris Dunn",1525,718,699,-19,532,486,134,129,52,84,175,190,357,296,115
"d/duranke01","Kevin Durant",2325,1391,1784,393,808,914,413,519,170,351,219,332,589,582,404
"e/ellenhe01","Henry Ellenson",329,159,151,-8,86,66,60,60,13,25,24,36,62,30,29
"e/ellinwa01","Wayne Ellington",2041,721,849,128,121,116,579,681,21,52,54,70,67,46,78
"e/embiijo01","Joel Embiid",1912,1265,1445,180,839,888,214,198,212,359,309,450,530,438,467
"e/ennisja01","James Ennis",1604,435,511,76,231,262,153,153,51,96,134,192,97,70,116
"e/ennisja01","James Ennis",1053,435,511,76,231,262,153,153,51,96,134,192,97,70,116
"e/ennisja01","James Ennis",551,435,511,76,231,262,153,153,51,96,134,192,97,70,116
"e/ennisty01","Tyler Ennis",683,237,223,-14,168,160,56,42,13,21,86,98,82,62,29
"e/evansja01","Jawun Evans",778,273,231,-42,198,148,54,45,21,38,70,64,128,84,49
"e/evansty01","Tyreke Evans",1607,894,1001,107,523,504,286,342,85,155,333,362,190,142,209
"e/exumda01","Dante Exum",235,102,114,12,69,74,18,15,15,25,37,50,32,24,31
"f/farieke01","Kenneth Faried",461,172,188,16,147,152,1,0,24,36,76,86,71,66,51
"f/favorde01","Derrick Favors",2153,795,944,149,639,762,63,42,93,140,337,518,302,244,215
"f/feldeka01","Kay Felder",140,76,57,-19,51,34,19,12,6,11,11,8,40,26,12
"f/feldeka01","Kay Felder",134,76,57,-19,51,34,19,12,6,11,11,8,40,26,12
"f/feliccr01","Cristiano Felicio",977,250,308,58,213,254,2,0,35,54,137,190,76,64,81
"f/feltora01","Raymond Felton",1365,570,562,-8,322,286,230,243,18,33,93,100,229,186,44
"f/fergute01","Terrance Ferguson",763,174,189,15,49,60,120,120,5,9,28,40,21,20,10
"f/ferreyo01","Yogi Ferrell",2282,776,838,62,372,354,359,402,45,82,110,128,262,226,103
"f/finnedo01","Dorian Finney-Smith",448,128,123,-5,54,52,67,60,7,11,25,36,29,16,15
"f/forbebr01","Bryn Forbes",1517,524,553,29,269,240,228,267,27,46,41,48,228,192,72
"f/fournev01","Evan Fournier",1837,877,1006,129,467,482,335,381,75,143,168,224,299,258,173
"f/foxde01","De'Aaron Fox",2026,881,844,-37,644,562,153,141,84,141,190,246,454,316,195
"f/fraziti01","Tim Frazier",838,186,176,-10,116,102,56,51,14,23,27,40,89,62,30
"f/fryech01","Channing Frye",695,219,264,45,97,130,115,117,7,17,39,62,58,68,19
"f/fryech01","Channing Frye",545,219,264,45,97,130,115,117,7,17,39,62,58,68,19
"f/fryech01","Channing Frye",150,219,264,45,97,130,115,117,7,17,39,62,58,68,19
"f/fultzma01","Markelle Fultz",253,121,100,-21,110,90,1,0,10,10,41,54,69,36,21
"g/gallida01","Danilo Gallinari",671,295,316,21,145,132,111,108,39,76,55,62,90,70,87
"g/gallola01","Langston Galloway",863,356,359,3,122,102,218,225,16,32,13,18,109,84,41
"g/gasolma01","Marc Gasol",2408,1172,1234,62,713,650,320,327,139,257,164,218,549,432,337
"g/gasolpa01","Pau Gasol",1812,721,775,54,506,488,120,129,95,158,195,262,311,226,209
"g/gayru01","Rudy Gay",1231,601,653,52,419,432,118,111,64,110,140,190,279,242,145
"g/georgpa01","Paul George",2891,1508,1716,208,731,664,608,732,169,320,263,352,468,312,412
"g/georgma01","Marcus Georges-Hunt",224,59,59,0,34,34,15,12,10,13,21,22,13,12,21
"g/gibsota01","Taj Gibson",2726,817,999,182,702,836,35,21,80,142,355,534,347,302,185
"g/ginobma01","Manu Ginobili",1299,518,571,53,270,274,193,192,55,105,131,168,139,106,131
"g/goberru01","Rudy Gobert",1816,572,756,184,443,552,0,0,129,204,336,488,107,64,299
"g/gordoaa01","Aaron Gordon",1909,957,1022,65,523,520,342,345,92,157,238,342,285,178,225
"g/gordoer01","Eric Gordon",2154,1066,1241,175,360,394,608,654,98,193,227,300,133,94,241
"g/gortama01","Marcin Gortat",2075,631,690,59,560,580,0,0,71,110,230,300,330,280,163
"g/grahatr01","Treveon Graham",1050,248,273,25,124,112,97,120,27,41,56,60,68,52,59
"g/grantje01","Jerami Grant",1647,561,682,121,346,424,110,96,105,162,267,366,79,58,240
"g/grantje02","Jerian Grant",1686,579,619,40,316,296,188,183,75,140,100,128,216,168,188
"g/greenda02","Danny Green",1791,589,599,10,241,202,320,348,28,49,97,106,144,96,65
"g/greendr01","Draymond Green",2287,697,773,76,363,408,256,231,78,134,220,306,143,102,173
"g/greenge01","Gerald Green",929,436,494,58,115,116,298,330,23,48,50,56,65,60,60
"g/greenja01","JaMychal Green",1542,538,569,31,361,360,127,129,50,80,218,272,143,88,111
"g/greenje02","Jeff Green",1828,723,842,119,449,484,170,159,104,199,246,344,203,140,234
"g/griffbl01","Blake Griffin",1970,1142,1237,95,675,650,322,333,145,254,283,386,392,264,330
"g/griffbl01","Blake Griffin",1139,1142,1237,95,675,650,322,333,145,254,283,386,392,264,330
"g/griffbl01","Blake Griffin",831,1142,1237,95,675,650,322,333,145,254,283,386,392,264,330
"h/hardati02","Tim Hardaway",1885,934,992,58,446,460,410,390,78,142,190,244,256,216,179
"h/hardeja01","James Harden",2551,1742,2167,425,726,772,722,795,294,600,395,520,331,252,727
"h/harklma01","Maurice Harkless",1264,324,385,61,179,196,118,147,27,42,136,168,43,28,59
"h/harremo01","Montrezl Harrell",1293,638,836,198,540,694,7,3,91,139,354,520,186,174,222
"h/harride01","Devin Harris",1340,525,594,69,227,216,227,237,71,141,133,168,94,48,170
"h/harride01","Devin Harris",807,525,594,69,227,216,227,237,71,141,133,168,94,48,170
"h/harride01","Devin Harris",533,525,594,69,227,216,227,237,71,141,133,168,94,48,170
"h/harriga01","Gary Harris",2304,977,1169,192,514,568,394,468,69,133,227,326,287,242,162
"h/harrijo01","Joe Harris",1975,662,842,180,264,310,358,450,40,82,161,226,103,84,104
"h/harrito02","Tobias Harris",2668,1308,1480,172,776,758,445,549,87,173,259,334,517,424,216
"h/harrito02","Tobias Harris",1563,1308,1480,172,776,758,445,549,87,173,259,334,517,424,216
"h/harrito02","Tobias Harris",1105,1308,1480,172,776,758,445,549,87,173,259,334,517,424,216
"h/harriaa01","Aaron Harrison",233,77,60,-17,26,20,43,27,8,13,8,10,18,10,17
"h/harrian01","Andrew Harrison",1326,497,532,35,287,268,142,141,68,123,129,148,158,120,159
"h/harrish01","Shaquille Harrison",384,140,152,12,98,106,26,18,16,28,84,102,14,4,38
"h/hartjo01","Josh Hart",1461,418,496,78,178,196,197,234,43,66,119,162,59,34,94
"h/hayesni01","Nigel Hayes",122,34,27,-7,17,14,16,12,1,1,4,2,13,12,3
"h/hayesni01","Nigel Hayes",105,34,27,-7,17,14,16,12,1,1,4,2,13,12,3
"h/henrymy01","Myke Henry",378,113,107,-6,51,44,58,57,4,6,34,36,17,8,10
"h/hensojo01","John Henson",1970,572,665,93,494,572,7,3,71,90,280,396,214,176,158
"h/hernaju01","Juan Hernangomez",277,80,82,2,25,30,50,42,5,10,15,24,10,6,12
"h/hernawi01","Willy Hernangomez",495,206,246,40,153,172,12,15,41,59,94,124,59,48,90
"h/hernawi01","Willy Hernangomez",233,206,246,40,153,172,12,15,41,59,94,124,59,48,90
"h/hernawi01","Willy Hernangomez",262,206,246,40,153,172,12,15,41,59,94,124,59,48,90
"h/hezonma01","Mario Hezonja",1657,662,720,58,349,366,267,270,46,84,152,210,197,156,105
"h/hicksis01","Isaiah Hicks",240,81,80,-1,63,62,9,6,9,12,37,48,26,14,18
"h/hieldbu01","Buddy Hield",2024,959,1061,102,525,480,408,528,26,53,149,188,376,292,81
"h/hilarne01","Nene Hilario",758,285,340,55,237,272,2,0,46,68,151,192,86,80,107
"h/hillge01","George Hill",1812,573,663,90,308,302,204,255,61,106,97,136,211,166,140
"h/hillge01","George Hill",1143,573,663,90,308,302,204,255,61,106,97,136,211,166,140
"h/hillge01","George Hill",669,573,663,90,308,302,204,255,61,106,97,136,211,166,140
"h/hillso01","Solomon Hill",187,44,29,-15,20,14,21,12,3,3,8,10,12,4,6
"h/holidjr01","Jrue Holiday",2927,1339,1529,190,887,990,356,360,96,179,371,498,516,492,238
"h/holidju01","Justin Holiday",2265,845,872,27,332,258,450,483,63,131,102,110,230,148,164
"h/hollajo02","John Holland",174,65,53,-12,23,12,36,33,6,8,11,8,12,4,13
"h/holliro01","Rondae Hollis-Jefferson",1920,858,946,88,670,658,54,39,134,249,273,326,397,332,316
"h/holmeri01","Richaun Holmes",746,264,311,47,211,262,31,12,22,37,123,196,88,66,56
"h/hoodro01","Rodney Hood",1616,804,879,75,418,390,333,381,53,108,76,100,342,290,129
"h/hoodro01","Rodney Hood",1084,804,879,75,418,390,333,381,53,108,76,100,342,290,129
"h/hoodro01","Rodney Hood",532,804,879,75,418,390,333,381,53,108,76,100,342,290,129
"h/horfoal01","Al Horford",2277,804,921,117,527,542,226,291,51,88,149,220,378,322,120
"h/houseda01","Danuel House",403,141,152,11,71,82,58,45,12,25,48,66,23,16,31
"h/howardw01","Dwight Howard",2463,1170,1347,177,904,1010,7,3,259,334,517,724,387,286,582
"h/huestjo01","Josh Huestis",982,191,159,-32,67,54,115,99,9,6,50,48,17,6,20
"i/ibakase01","Serge Ibaka",2093,835,959,124,487,544,297,321,51,94,127,184,360,360,118
"i/iguodan01","Andre Iguodala",1622,358,384,26,203,230,117,99,38,55,100,152,103,78,87
"i/ilyaser01","Ersan Ilyasova",1729,673,750,77,360,372,253,273,60,105,183,228,177,144,135
"i/ilyaser01","Ersan Ilyasova",1175,673,750,77,360,372,253,273,60,105,183,228,177,144,135
"i/ilyaser01","Ersan Ilyasova",554,673,750,77,360,372,253,273,60,105,183,228,177,144,135
"i/inglejo01","Joe Ingles",2578,754,939,185,254,262,464,612,36,65,118,160,136,102,83
"i/ingrabr01","Brandon Ingram",1975,886,949,63,656,634,105,123,125,192,285,382,371,252,282
"i/irvinky01","Kyrie Irving",1931,1189,1448,259,680,736,407,498,102,214,242,314,438,422,261
"i/isaacjo01","Jonathan Isaac",536,156,145,-11,99,78,46,48,11,19,27,44,72,34,25
"i/iwundwe01","Wesley Iwundu",1020,239,229,-10,172,168,46,27,21,34,85,108,87,60,47
"j/jackja01","Jarrett Jack",1548,476,465,-11,357,328,86,75,33,62,55,72,302,256,75
"j/jacksjo02","Josh Jackson",1959,1058,1012,-46,715,664,217,171,126,177,325,376,390,288,279
"j/jacksju01","Justin Jackson",1506,432,453,21,234,256,185,171,13,26,78,118,156,138,36
"j/jacksre01","Reggie Jackson",1201,634,653,19,408,388,169,156,57,109,90,108,318,280,134
"j/jamesle01","LeBron James",3026,1797,2248,451,1174,1416,406,447,217,385,668,1024,506,392,531
"j/jamesmi02","Mike James",687,357,336,-21,222,194,98,78,37,64,77,86,145,108,84
"j/jamesmi02","Mike James",669,357,336,-21,222,194,98,78,37,64,77,86,145,108,84
"j/jeffeal01","Al Jefferson",484,220,252,32,205,222,3,0,12,30,59,68,146,154,36
"j/jefferi01","Richard Jefferson",163,30,30,0,20,20,7,6,3,4,6,8,14,12,7
"j/jennibr01","Brandon Jennings",205,75,73,-2,39,36,33,27,3,10,9,10,30,26,10
"j/jerebjo01","Jonas Jerebko",1134,366,429,63,184,188,157,195,25,46,89,126,95,62,57
"j/johnsam01","Amir Johnson",1171,300,342,42,229,260,32,30,39,52,112,160,117,100,85
"j/johnsda04","Dakari Johnson",161,49,55,6,39,44,0,0,10,11,21,26,18,18,20
"j/johnsja01","James Johnson",1943,680,788,108,429,504,185,171,66,113,235,328,194,176,162
"j/johnsjo02","Joe Johnson",1205,379,370,-9,215,212,145,120,19,38,12,16,203,196,44
"j/johnsjo02","Joe Johnson",700,379,370,-9,215,212,145,120,19,38,12,16,203,196,44
"j/johnsjo02","Joe Johnson",505,379,370,-9,215,212,145,120,19,38,12,16,203,196,44
"j/johnsst04","Stanley Johnson",1894,628,599,-29,326,286,234,201,68,112,123,162,203,124,145
"j/johnsty01","Tyler Johnson",2052,763,835,72,387,380,324,357,52,98,141,180,246,200,129
"j/johnswe01","Wesley Johnson",1486,394,402,8,191,180,177,180,26,42,57,74,134,106,58
"j/jokicni01","Nikola Jokic",2443,1141,1385,244,728,786,280,333,133,266,227,306,501,480,313
"j/jonesde02","Derrick Jones",245,64,61,-3,35,36,18,9,11,16,19,26,16,10,24
"j/jonesde02","Derrick Jones",212,64,61,-3,35,36,18,9,11,16,19,26,16,10,24
"j/jonesja04","Jalen Jones",181,75,74,-1,41,32,26,30,8,12,26,28,15,4,19
"j/jonesja04","Jalen Jones",162,75,74,-1,41,32,26,30,8,12,26,28,15,4,19
"j/jonesty01","Tyus Jones",1467,362,415,53,199,210,129,135,34,70,75,102,124,108,81
"j/jordade01","DeAndre Jordan",2424,716,927,211,575,746,0,0,141,181,487,684,88,62,312
"j/josepco01","Cory Joseph",2210,644,646,2,413,378,190,201,41,67,103,124,310,254,95
"k/kaminfr01","Frank Kaminsky",1835,798,870,72,442,406,274,312,82,152,122,164,320,242,194
"k/kanteen01","Enes Kanter",1830,791,1000,209,710,844,2,0,79,156,435,594,275,250,184
"k/kennalu01","Luke Kennard",1463,494,550,56,270,250,195,243,29,57,62,74,208,176,76
"k/kiddgmi01","Michael Kidd-Gilchrist",1850,636,681,45,558,564,2,0,76,117,226,312,332,252,171
"k/kilpase01","Sean Kilpatrick",640,324,329,5,150,128,143,138,31,63,64,70,86,58,72
"k/kilpase01","Sean Kilpatrick",183,324,329,5,150,128,143,138,31,63,64,70,86,58,72
"k/kilpase01","Sean Kilpatrick",205,324,329,5,150,128,143,138,31,63,64,70,86,58,72
"k/kilpase01","Sean Kilpatrick",214,324,329,5,150,128,143,138,31,63,64,70,86,58,72
"k/klebima01","Maxi Kleber",1206,335,385,50,181,222,128,120,26,43,113,156,68,66,59
"k/kornelu01","Luke Kornet",326,129,134,5,46,42,79,84,4,8,24,34,22,8,11
"k/korveky01","Kyle Korver",1574,507,656,149,108,116,376,492,23,48,30,44,78,72,72
"k/koufoko01","Kosta Koufos",1391,422,477,55,389,444,0,0,33,33,152,216,237,228,74
"k/kuzmaky01","Kyle Kuzma",2401,1125,1238,113,603,618,436,477,86,143,267,342,336,276,208
"l/labissk01","Skal Labissiere",1240,507,523,16,407,374,51,54,49,95,117,162,290,212,118
"l/lambje01","Jeremy Lamb",1967,915,1027,112,578,572,253,282,84,173,170,220,408,352,208
"l/larkish01","Shane Larkin",775,237,231,-6,133,106,86,93,18,32,53,56,80,50,37
"l/lauvejo01","Joffrey Lauvergne",534,212,226,14,185,196,5,0,22,30,103,136,82,60,47
"l/lavinza01","Zach LaVine",656,400,397,-3,232,188,123,126,45,83,113,124,119,64,107
"l/laymaja01","Jake Layman",160,48,34,-14,27,20,20,12,1,2,10,14,17,6,3
"l/leaftj01","T.J. Leaf",459,142,156,14,94,92,42,54,6,10,49,60,45,32,16
"l/leeco01","Courtney Lee",2310,803,899,96,477,460,278,339,48,100,125,162,352,298,124
"l/leeda03","Damion Lee",404,164,161,-3,92,94,60,45,12,22,27,42,65,52,29
"l/lenal01","Alex Len",1395,479,587,108,375,426,3,3,101,158,277,358,98,68,231
"l/leonaka01","Kawhi Leonard",210,127,144,17,76,82,35,33,16,29,23,34,53,48,38
"l/leoname01","Meyers Leonard",254,82,112,30,52,70,26,33,4,9,19,30,33,40,11
"l/leuerjo01","Jon Leuer",136,42,43,1,33,30,3,0,6,13,14,20,19,10,15
"l/leverca01","Caris LeVert",1864,812,858,46,490,470,245,255,77,133,228,298,262,172,187
"l/liggide01","DeAndre Liggins",724,108,101,-7,53,42,53,57,2,2,20,18,33,24,5
"l/liggide01","DeAndre Liggins",480,108,101,-7,53,42,53,57,2,2,20,18,33,24,5
"l/liggide01","DeAndre Liggins",244,108,101,-7,53,42,53,57,2,2,20,18,33,24,5
"l/lillada01","Damian Lillard",2670,1630,1927,297,786,788,629,681,215,458,385,424,401,364,538
"l/livinsh01","Shaun Livingston",1129,366,392,26,338,344,5,0,23,48,81,116,257,228,61
"l/looneke01","Kevon Looney",910,227,267,40,187,222,5,3,35,42,121,180,66,42,77
"l/lopezbr01","Brook Lopez",1735,859,961,102,469,514,325,336,65,111,142,210,327,304,158
"l/lopezro01","Robin Lopez",1690,682,755,73,631,676,14,12,37,67,203,296,428,380,90
"l/loveke01","Kevin Love",1651,844,1024,180,400,394,330,411,114,219,177,234,223,160,266
"l/lowryky01","Kyle Lowry",2510,1052,1265,213,348,330,596,714,108,221,165,216,183,114,261
"l/luwawti01","Timothe Luwawu-Cabarrot",807,293,299,6,109,94,158,159,26,46,77,84,32,10,58
"l/lylestr01","Trey Lyles",1391,614,724,110,332,374,218,249,64,101,165,230,167,144,145
"m/macksh01","Shelvin Mack",1365,458,473,15,275,260,139,144,44,69,95,134,180,126,97
"m/magetjo01","Josh Magette",216,50,46,-4,24,14,22,24,4,8,1,0,23,14,8
"m/mahinia01","Ian Mahinmi",1145,304,364,60,245,276,2,0,57,88,154,206,91,70,128
"m/makerth01","Thon Maker",1238,358,356,-2,212,198,104,93,42,65,90,98,122,100,93
"m/marjabo01","Boban Marjanovic",337,192,235,43,148,158,0,0,44,77,67,98,81,60,97
"m/marjabo01","Boban Marjanovic",171,192,235,43,148,158,0,0,44,77,67,98,81,60,97
"m/marjabo01","Boban Marjanovic",166,192,235,43,148,158,0,0,44,77,67,98,81,60,97
"m/markkla01","Lauri Markkanen",2020,924,1028,104,461,458,401,435,62,135,210,284,251,174,166
"m/martija01","Jarell Martin",1661,551,565,14,398,374,98,102,55,89,205,234,193,140,116
"m/masonfr01","Frank Mason",984,431,413,-18,294,226,86,93,51,94,106,98,188,128,115
"m/matthwe02","Wesley Matthews",2131,741,801,60,295,260,402,459,44,82,67,68,228,192,101
"m/mbahalu01","Luc Mbah a Moute",1564,387,460,73,172,206,173,189,42,65,139,188,33,18,95
"m/mccawpa01","Patrick McCaw",961,240,229,-11,146,146,80,57,14,26,78,102,68,44,34
"m/mccolcj01","CJ McCollum",2923,1607,1725,118,1028,956,476,567,103,202,276,302,752,654,250
"m/mccontj01","T.J. McConnell",1706,438,476,38,359,366,62,81,17,29,98,130,261,236,39
"m/mcderdo01","Doug McDermott",1768,540,629,89,292,290,216,276,32,63,158,206,134,84,81
"m/mcderdo01","Doug McDermott",1172,540,629,89,292,290,216,276,32,63,158,206,134,84,81
"m/mcderdo01","Doug McDermott",596,540,629,89,292,290,216,276,32,63,158,206,134,84,81
"m/mcgeeja01","JaVale McGee",615,241,310,69,213,272,6,0,22,38,136,204,77,68,52
"m/mcgruro01","Rodney McGruder",299,77,91,14,38,42,35,45,4,4,16,28,22,14,8
"m/mclembe01","Ben McLemore",1091,401,422,21,214,204,159,165,28,53,90,108,124,96,64
"m/meeksjo01","Jodie Meeks",1119,439,478,39,183,170,210,216,46,92,47,68,136,102,117
"m/mejrisa01","Salah Mejri",729,168,214,46,134,176,3,0,31,38,108,154,26,22,66
"m/mickejo01","Jordan Mickey",284,90,93,3,66,74,16,6,8,13,41,50,25,24,19
"m/middlkh01","Khris Middleton",2982,1407,1617,210,865,894,406,438,136,285,178,224,687,670,362
"m/milescj01","C.J. Miles",1337,633,696,63,144,126,454,492,35,78,57,76,87,50,97
"m/milleda01","Darius Miller",1944,508,632,124,129,138,358,441,21,53,10,12,119,126,67
"m/millema01","Malcolm Miller",126,30,38,8,7,10,21,24,2,4,7,10,0,0,4
"m/millspa02","Patty Mills",2107,729,810,81,269,252,414,462,46,96,77,88,192,164,118
"m/millspa01","Paul Millsap",1143,507,555,48,323,326,113,117,71,112,87,112,236,214,161
"m/mirotni01","Nikola Mirotic",1494,741,856,115,324,342,358,405,59,109,134,180,190,162,137
"m/mirotni01","Nikola Mirotic",622,741,856,115,324,342,358,405,59,109,134,180,190,162,137
"m/mirotni01","Nikola Mirotic",872,741,856,115,324,342,358,405,59,109,134,180,190,162,137
"m/mitchdo01","Donovan Mitchell",2638,1486,1606,120,813,816,549,561,124,229,354,452,459,364,297
"m/monkma01","Malik Monk",854,442,421,-21,182,140,243,249,17,32,43,52,139,88,37
"m/monrogr01","Greg Monroe",1040,439,524,85,386,436,0,0,53,88,199,290,187,146,119
"m/monrogr01","Greg Monroe",465,439,524,85,386,436,0,0,53,88,199,290,187,146,119
"m/monrogr01","Greg Monroe",496,439,524,85,386,436,0,0,53,88,199,290,187,146,119
"m/mooreet01","E'Twaun Moore",2586,859,1021,162,531,590,301,384,27,47,187,240,344,350,68
"m/moreler01","Eric Moreland",805,134,143,9,122,132,0,0,12,11,70,94,52,38,29
"m/morrima03","Marcus Morris",1447,675,734,59,377,352,234,258,64,124,85,104,292,248,154
"m/morrima02","Markieff Morris",1968,742,838,96,480,508,207,228,55,102,133,186,347,322,128
"m/motlejo01","Johnathan Motley",176,88,96,8,69,78,6,3,13,15,24,38,45,40,28
"m/mozgoti01","Timofey Mozgov",359,106,131,25,75,96,18,12,13,23,51,74,24,22,30
"m/mudiaem01","Emmanuel Mudiay",1245,580,552,-28,378,314,147,141,55,97,125,140,253,174,129
"m/mudiaem01","Emmanuel Mudiay",752,580,552,-28,378,314,147,141,55,97,125,140,253,174,129
"m/mudiaem01","Emmanuel Mudiay",493,580,552,-28,378,314,147,141,55,97,125,140,253,174,129
"m/muhamsh01","Shabazz Muhammad",418,210,214,4,161,154,27,21,22,39,71,88,90,66,50
"m/muhamsh01","Shabazz Muhammad",301,210,214,4,161,154,27,21,22,39,71,88,90,66,50
"m/muhamsh01","Shabazz Muhammad",117,210,214,4,161,154,27,21,22,39,71,88,90,66,50
"m/murrade01","Dejounte Murray",1743,676,656,-20,575,524,34,27,67,105,251,294,324,230,148
"m/murraja01","Jamal Murray",2565,1156,1337,181,626,628,436,495,94,214,206,256,420,372,253
"m/muscami01","Mike Muscala",1060,339,402,63,146,162,167,186,26,54,72,100,74,62,62
"n/naderab01","Abdel Nader",522,166,146,-20,84,54,65,69,17,23,38,34,46,20,39
"n/nancela02","Larry Nance",1421,475,573,98,402,476,12,6,61,91,240,352,162,124,137
"n/nancela02","Larry Nance",922,475,573,98,402,476,12,6,61,91,240,352,162,124,137
"n/nancela02","Larry Nance",499,475,573,98,402,476,12,6,61,91,240,352,162,124,137
"n/napiesh01","Shabazz Napier",1535,590,643,53,313,282,218,246,59,115,102,114,211,168,138
"n/nelsoja01","Jameer Nelson",1013,253,247,-6,120,108,124,123,9,16,34,46,86,62,20
"n/nelsoja01","Jameer Nelson",897,253,247,-6,120,108,124,123,9,16,34,46,86,62,20
"n/nelsoja01","Jameer Nelson",116,253,247,-6,120,108,124,123,9,16,34,46,86,62,20
"n/netora01","Raul Neto",498,166,183,17,104,100,47,57,15,26,47,60,57,40,35
"n/noelne01","Nerlens Noel",472,117,131,14,104,110,1,0,12,21,63,78,41,32,28
"n/noguelu01","Lucas Nogueira",418,92,122,30,61,88,19,15,12,19,56,86,5,2,28
"n/nowitdi01","Dirk Nowitzki",1900,799,914,115,421,416,337,414,41,84,33,50,388,366,108
"n/ntilila01","Frank Ntilikina",1706,531,463,-68,343,264,157,150,31,49,87,108,256,156,68
"n/nurkiju01","Jusuf Nurkic",2088,1068,1132,64,944,960,7,0,117,172,443,570,501,390,273
"n/nwabada01","David Nwaba",1646,515,555,40,371,368,52,54,92,133,223,276,148,92,203
"o/obryajo01","Johnny O'Bryant",379,183,171,-12,128,108,43,42,12,21,37,48,91,60,25
"o/onealro01","Royce O'Neale",1150,317,343,26,166,156,118,126,33,61,94,108,72,48,76
"o/oquinky01","Kyle O'Quinn",1387,439,550,111,367,440,17,12,55,98,183,258,184,182,127
"o/ojelese01","Semi Ojeleye",1150,206,195,-11,63,50,125,120,18,25,31,30,32,20,41
"o/okafoem01","Emeka Okafor",353,104,114,10,95,96,0,0,9,18,45,58,50,38,22
"o/okafoja01","Jahlil Okafor",353,150,176,26,134,152,4,3,12,21,59,80,75,72,29
"o/okafoja01","Jahlil Okafor",328,150,176,26,134,152,4,3,12,21,59,80,75,72,29
"o/oladivi01","Victor Oladipo",2552,1500,1727,227,906,958,434,483,160,286,358,494,548,464,368
"o/olynyke01","Kelly Olynyk",1779,712,872,160,355,420,281,318,76,134,174,272,181,148,174
"o/osmande01","Cedi Osman",672,206,238,32,99,116,87,96,20,26,46,70,53,46,46
"o/oubreke01","Kelly Oubre",2231,892,952,60,421,384,369,378,102,190,191,246,230,138,233
"p/pachuza01","Zaza Pachulia",972,303,372,69,262,298,1,0,40,74,162,212,100,86,93
"p/papagge01","Georgios Papagiannis",122,42,36,-6,42,36,0,0,0,0,18,18,24,18,0
"p/papagge01","Georgios Papagiannis",118,42,36,-6,42,36,0,0,0,0,18,18,24,18,0
"p/parkeja01","Jabari Parker",743,357,391,34,251,258,81,93,25,40,116,144,135,114,54
"p/parketo01","Tony Parker",1071,423,421,-2,351,336,37,30,35,55,131,164,220,172,78
"p/parsoch01","Chandler Parsons",691,245,284,39,113,114,121,153,11,17,37,52,76,62,27
"p/pattepa01","Patrick Patterson",1270,287,318,31,94,80,171,198,22,40,34,40,60,40,46
"p/paulbr01","Brandon Paul",576,145,145,0,72,78,54,45,19,22,40,56,32,22,43
"p/paulch01","Chris Paul",1847,889,1067,178,419,446,379,432,91,189,74,98,345,348,221
"p/payneca01","Cameron Payne",582,222,221,-1,124,104,91,105,7,12,42,54,82,50,16
"p/paytoel01","Elfrid Payton",1808,737,797,60,575,598,92,90,70,109,270,364,305,234,168
"p/paytoel01","Elfrid Payton",1257,737,797,60,575,598,92,90,70,109,270,364,305,234,168
"p/paytoel01","Elfrid Payton",551,737,797,60,575,598,92,90,70,109,270,364,305,234,168
"p/paytoga02","Gary Payton",221,78,69,-9,49,48,25,18,4,3,34,40,15,8,9
"p/paytoga02","Gary Payton",106,78,69,-9,49,48,25,18,4,3,34,40,15,8,9
"p/paytoga02","Gary Payton",115,78,69,-9,49,48,25,18,4,3,34,40,15,8,9
"p/peteral01","Alec Peters",225,77,81,4,16,20,58,54,3,7,10,12,6,8,10
"p/plumlma01","Mason Plumlee",1439,446,524,78,367,442,1,0,78,82,248,354,119,88,180
"p/plumlmi01","Miles Plumlee",918,209,237,28,180,210,0,0,29,27,117,166,63,44,60
"p/poeltja01","Jakob Poeltl",1524,423,567,144,382,504,2,3,39,60,282,414,100,90,101
"p/pondequ01","Quincy Pondexter",196,57,45,-12,27,22,22,9,8,14,18,18,9,4,17
"p/porteot01","Otto Porter",2432,940,1134,194,572,614,313,414,55,106,157,222,415,392,128
"p/portibo01","Bobby Portis",1643,874,964,90,587,604,223,240,64,120,240,282,347,322,156
"p/porzikr01","Kristaps Porzingis",1553,1007,1082,75,660,600,229,270,118,212,139,168,521,432,275
"p/poweldw01","Dwight Powell",1672,509,671,162,346,454,84,84,79,133,236,366,110,88,185
"p/powelno01","Norman Powell",1062,389,385,-4,188,194,186,159,15,32,104,124,84,70,39
"p/poythal01","Alex Poythress",104,26,26,0,15,14,11,12,0,0,12,14,3,0,0
"p/purviro01","Rodney Purvis",290,113,93,-20,55,44,52,39,6,10,13,14,42,30,15
"q/qizh01","Zhou Qi",124,38,22,-16,13,8,19,6,6,8,7,6,6,2,12
"r/rabbiv01","Ivan Rabb",516,168,201,33,152,172,0,0,16,29,70,96,82,76,36
"r/randlju01","Julius Randle",2190,1087,1323,236,858,988,45,30,184,305,493,718,365,270,425
"r/randoza01","Zach Randolph",1508,806,857,51,616,620,147,153,43,84,175,218,441,402,107
"r/rathaxa01","Xavier Rathan-Mayes",118,46,29,-17,28,22,14,3,4,4,7,10,21,12,9
"r/redicjj01","J.J. Redick",2116,956,1174,218,420,422,460,579,76,173,66,80,354,342,218
"r/reedda01","Davon Reed",242,82,63,-19,38,22,38,33,6,8,13,8,25,14,12
"r/reedwi02","Willie Reed",428,146,195,49,119,160,2,3,25,32,71,112,48,48,55
"r/reedwi02","Willie Reed",419,146,195,49,119,160,2,3,25,32,71,112,48,48,55
"r/richajo01","Josh Richardson",2689,943,1044,101,549,544,336,381,58,119,176,214,373,330,142
"r/richama01","Malachi Richardson",324,100,89,-11,50,36,40,36,10,17,21,14,29,22,22
"r/richama01","Malachi Richardson",319,100,89,-11,50,36,40,36,10,17,21,14,29,22,22
"r/riverau01","Austin Rivers",2057,875,920,45,445,410,360,408,70,102,232,264,213,146,159
"r/roberan03","Andre Roberson",1037,180,194,14,126,158,36,24,18,12,116,158,10,0,38
"r/robingl02","Glenn Robinson",338,90,95,5,51,44,34,42,5,9,16,20,35,24,11
"r/rondora01","Rajon Rondo",1705,515,537,22,344,362,150,150,21,25,199,240,145,122,46
"r/rosede01","Derrick Rose",420,208,209,1,156,148,30,21,22,40,78,104,78,44,46
"r/rosede01","Derrick Rose",308,208,209,1,156,148,30,21,22,40,78,104,78,44,46
"r/rosede01","Derrick Rose",112,208,209,1,156,148,30,21,22,40,78,104,78,44,46
"r/rosste01","Terrence Ross",600,205,209,4,98,92,93,90,14,27,24,36,74,56,36
"r/roziete01","Terry Rozier",2068,866,900,34,398,326,402,459,66,115,144,154,254,172,149
"r/rubiori01","Ricky Rubio",2254,935,988,53,554,500,273,288,108,200,142,152,412,348,254
"r/russeda01","D'Angelo Russell",1234,725,742,17,394,376,277,270,54,96,107,136,287,240,131
"s/sabondo01","Domantas Sabonis",1810,758,861,103,624,654,37,39,97,168,311,416,313,238,224
"s/sampsja02","JaKarr Sampson",344,87,103,16,71,78,10,15,6,10,42,58,29,20,16
"s/saricda01","Dario Saric",2310,978,1135,157,490,492,399,471,89,172,224,296,266,196,207
"s/satorto01","Tomas Satoransky",1643,428,524,96,283,308,101,141,44,75,102,142,181,166,96
"s/schrode01","Dennis Schroder",2078,1256,1293,37,883,848,262,228,111,217,332,384,551,464,266
"s/scottmi01","Mike Scott",1406,555,667,112,361,420,163,198,31,49,88,122,273,298,76
"s/sefolth01","Thabo Sefolosha",806,265,312,47,156,172,84,96,25,44,80,110,76,62,54
"s/seldewa01","Wayne Selden",692,295,325,30,147,134,122,147,26,44,55,66,92,68,59
"s/sessira01","Ramon Sessions",392,142,136,-6,90,68,26,24,26,44,41,42,49,26,57
"s/sessira01","Ramon Sessions",167,142,136,-6,90,68,26,24,26,44,41,42,49,26,57
"s/sessira01","Ramon Sessions",225,142,136,-6,90,68,26,24,26,44,41,42,49,26,57
"s/shumpim01","Iman Shumpert",276,65,62,-3,32,30,26,21,7,11,7,10,25,20,15
"s/siakapa01","Pascal Siakam",1679,530,587,57,366,448,132,87,32,52,227,326,139,122,85
"s/simmobe01","Ben Simmons",2732,1156,1279,123,988,1088,11,0,157,191,462,686,526,402,341
"s/simmojo02","Jonathon Simmons",2029,861,961,100,556,568,204,210,101,183,205,282,351,286,241
"s/simmoko01","Kobi Simmons",643,200,196,-4,150,138,39,33,11,25,59,84,91,54,25
"s/smartma01","Marcus Smart",1614,574,544,-30,266,228,249,225,59,91,91,108,175,120,133
"s/smithde03","Dennis Smith",2049,1109,1048,-61,684,596,339,318,86,134,325,394,359,202,193
"s/smithis01","Ish Smith",2043,851,894,43,700,708,101,105,50,81,206,276,494,432,116
"s/smithjr01","J.R. Smith",2244,620,662,42,214,194,381,429,25,39,53,60,161,134,56
"s/smithja02","Jason Smith",285,123,113,-10,83,82,32,12,8,19,24,34,59,48,21
"s/snellto01","Tony Snell",2053,447,515,68,157,154,268,324,22,37,71,92,86,62,48
"s/speigma01","Marreese Speights",675,374,402,28,116,104,233,258,25,40,26,26,90,78,55
"s/stausni01","Nik Stauskas",523,166,181,15,54,40,100,120,12,21,28,30,26,10,29
"s/stausni01","Nik Stauskas",478,166,181,15,54,40,100,120,12,21,28,30,26,10,29
"s/stephla01","Lance Stephenson",1850,766,757,-9,477,472,232,201,57,84,207,258,270,214,127
"s/stoneju01","Julyan Stone",175,14,19,5,0,0,13,18,1,1,0,0,0,0,2
"s/swanica01","Caleb Swanigan",189,67,61,-6,52,46,8,3,7,12,30,32,22,14,18
"t/tatumja01","Jayson Tatum",2438,950,1110,160,593,584,242,315,115,211,267,336,326,248,258
"t/taylois01","Isaiah Taylor",1167,455,445,-10,310,286,80,60,65,99,146,178,164,108,141
"t/teaguje01","Jeff Teague",2311,899,989,90,565,540,228,252,106,197,166,216,399,324,239
"t/teletmi01","Mirza Teletovic",159,57,71,14,12,8,45,63,0,0,3,2,9,6,0
"t/templga01","Garrett Temple",1615,509,545,36,249,220,227,267,33,58,74,94,175,126,78
"t/teodomi01","Milos Teodosic",1134,382,428,46,128,126,232,264,22,38,23,30,105,96,46
"t/terryja01","Jason Terry",814,157,164,7,39,38,115,120,3,6,13,14,26,24,9
"t/theisda01","Daniel Theis",936,269,331,62,175,216,58,54,36,61,108,160,67,56,81
"t/thomais02","Isaiah Thomas",862,479,484,5,233,204,188,165,58,115,81,82,152,122,131
"t/thomais02","Isaiah Thomas",406,479,484,5,233,204,188,165,58,115,81,82,152,122,131
"t/thomais02","Isaiah Thomas",456,479,484,5,233,204,188,165,58,115,81,82,152,122,131
"t/thomala01","Lance Thomas",1353,292,298,6,143,104,124,150,25,44,61,62,82,42,53
"t/thompkl01","Klay Thompson",2506,1224,1460,236,660,692,521,687,43,81,143,194,517,498,98
"t/thomptr01","Tristan Thompson",1072,270,307,37,236,264,0,0,34,43,156,210,80,54,79
"t/thornsi01","Sindarius Thornwell",1156,271,282,11,172,154,61,69,38,59,93,94,79,60,88
"t/tollian01","Anthony Tolliver",1757,525,702,177,107,120,365,477,53,105,65,92,42,28,132
"t/townska01","Karl-Anthony Towns",2918,1344,1741,397,886,1038,285,360,173,343,400,578,486,460,402
"t/tuckepj01","P.J. Tucker",2281,468,502,34,131,114,310,345,27,43,66,74,65,40,60
"t/turneev01","Evan Turner",2034,625,648,23,445,432,132,126,48,90,74,100,371,332,107
"t/turnemy01","Myles Turner",1836,732,827,95,482,500,157,168,93,159,166,204,316,296,206
"u/udohek01","Ekpe Udoh",810,144,162,18,119,120,1,0,24,42,65,86,54,34,56
"u/ulisty01","Tyler Ulis",1658,598,553,-45,405,344,146,126,47,83,64,56,341,288,101
"v/valanjo01","Jonas Valanciunas",1727,783,980,197,614,720,74,90,95,170,304,428,310,292,211
"v/valende01","Denzel Valentine",2095,740,777,37,351,316,370,429,19,32,84,102,267,214,51
"v/vanvlfr01","Fred VanVleet",1520,588,656,68,284,248,261,324,43,84,178,202,106,46,101
"v/vaughra01","Rashad Vaughn",212,59,64,5,19,18,37,42,3,4,6,8,13,10,6
"v/vaughra01","Rashad Vaughn",173,59,64,5,19,18,37,42,3,4,6,8,13,10,6
"v/vonleno01","Noah Vonleh",875,260,264,4,168,168,66,60,26,36,88,110,80,58,58
"v/vonleno01","Noah Vonleh",476,260,264,4,168,168,66,60,26,36,88,110,80,58,58
"v/vonleno01","Noah Vonleh",399,260,264,4,168,168,66,60,26,36,88,110,80,58,58
"v/vucevni01","Nikola Vucevic",1683,880,936,56,636,670,204,192,40,74,179,266,457,404,94
"w/wadedw01","Dwyane Wade",1536,767,764,-3,573,534,111,96,83,134,211,278,362,256,189
"w/wadedw01","Dwyane Wade",1069,767,764,-3,573,534,111,96,83,134,211,278,362,256,189
"w/wadedw01","Dwyane Wade",467,767,764,-3,573,534,111,96,83,134,211,278,362,256,189
"w/waitedi01","Dion Waiters",918,443,429,-14,240,222,170,156,33,51,101,124,139,98,69
"w/walkeke02","Kemba Walker",2736,1532,1753,221,761,712,602,696,169,345,308,352,453,360,420
"w/walljo01","John Wall",1410,771,795,24,498,436,167,186,106,173,207,264,291,172,241
"w/wallaty01","Tyrone Wallace",851,284,291,7,207,200,40,30,37,61,87,116,120,84,78
"p/princta02","Taurean Waller-Prince",2464,1050,1152,102,518,478,457,528,75,146,228,278,290,200,180
"w/waltode01","Derrick Walton",147,28,29,1,8,2,17,21,3,6,0,0,8,2,6
"w/warretj01","T.J. Warren",2142,1169,1266,97,973,1018,90,60,106,188,402,548,571,470,255
"w/weartr01","Travis Wear",228,76,75,-1,25,16,47,51,4,8,1,2,24,14,8
"w/webbja01","James Webb",120,24,16,-8,5,4,19,12,0,0,3,4,2,0,0
"w/weberbr01","Briante Weber",237,48,50,2,32,30,11,12,5,8,12,14,20,16,10
"w/weberbr01","Briante Weber",118,48,50,2,32,30,11,12,5,8,12,14,20,16,10
"w/weberbr01","Briante Weber",119,48,50,2,32,30,11,12,5,8,12,14,20,16,10
"w/westda01","David West",999,412,495,83,370,426,8,9,34,60,127,194,243,232,79
"w/westbru01","Russell Westbrook",2914,1924,2016,92,1361,1320,326,291,237,405,633,774,728,546,565
"w/whitean01","Andrew White",209,74,69,-5,24,14,49,54,1,1,7,6,17,8,4
"w/whitede01","Derrick White",139,43,54,11,20,16,13,24,10,14,5,4,15,12,20
"w/whiteis01","Isaiah Whitehead",180,94,100,6,68,66,18,21,8,13,30,42,38,24,19
"w/whiteha01","Hassan Whiteside",1364,652,754,102,576,620,2,6,74,128,252,358,324,262,182
"w/wiggian01","Andrew Wiggins",2979,1439,1451,12,962,914,338,336,139,201,298,414,664,500,314
"w/wilkida02","Damien Wilkins",152,41,33,-8,21,18,18,12,2,3,8,6,13,12,4
"w/willicj01","C.J. Williams",707,205,209,4,119,130,78,66,8,13,45,68,74,62,16
"w/willilo02","Lou Williams",2589,1544,1753,209,818,792,519,558,207,403,297,358,521,434,491
"w/willima02","Marvin Williams",2006,616,744,128,257,264,306,378,53,102,130,152,127,112,123
"w/willitr02","Troy Williams",307,121,133,12,71,80,38,33,12,20,56,70,15,10,30
"w/willitr02","Troy Williams",290,121,133,12,71,80,38,33,12,20,56,70,15,10,30
"w/wilsoja02","Jamil Wilson",274,83,105,22,18,22,63,81,2,2,6,10,12,12,4
"w/winslju01","Justise Winslow",1680,532,529,-3,357,316,130,147,45,66,179,202,178,114,104
"w/wrighbr03","Brandan Wright",381,116,139,23,102,118,0,0,14,21,71,98,31,20,33
"w/wrighbr03","Brandan Wright",366,116,139,23,102,118,0,0,14,21,71,98,31,20,33
"w/wrighde01","Delon Wright",1433,483,557,74,278,290,154,168,51,99,170,214,108,76,119
"y/yabusgu01","Guerschon Yabusele",235,71,79,8,24,28,37,36,10,15,13,20,11,8,22
"y/youngjo01","Joe Young",558,197,205,8,120,110,66,75,11,20,42,46,78,64,29
"y/youngni01","Nick Young",1393,514,581,67,162,156,326,369,26,56,34,46,128,110,65
"y/youngth01","Thaddeus Young",2607,906,955,49,684,726,181,174,41,55,334,418,350,308,92
"z/zelleco01","Cody Zeller",627,192,233,41,151,166,3,6,38,61,97,118,54,48,85
"z/zellety01","Tyler Zeller",1109,365,441,76,306,354,28,30,31,57,177,238,129,116,79
"z/zellety01","Tyler Zeller",703,365,441,76,306,354,28,30,31,57,177,238,129,116,79
"z/zellety01","Tyler Zeller",406,365,441,76,306,354,28,30,31,57,177,238,129,116,79
"z/zipsepa01","Paul Zipser",824,247,218,-29,124,88,110,111,13,19,35,44,89,44,26
"z/zizican01","Ante Zizic",214,79,119,40,67,98,0,0,12,21,41,70,26,28,29
"z/zubaciv01","Ivica Zubac",410,146,161,15,121,122,1,0,24,39,71,90,50,32,51
