"player_id","player_nm","mp","poss","pts","diff","poss2","pts2","poss3","pts3","possft","ptsft","poss2_rim","pts2_rim","poss2_other","pts2_other","tot_fta"
"a/acyqu01","Quincy Acy",847,165,171,6,126,124,15,12,24,35,56,74,70,50,53
"a/acyqu01","Quincy Acy",786,165,171,6,126,124,15,12,24,35,56,74,70,50,53
"a/adamsst01","Steven Adams",1197,250,265,15,185,186,0,0,65,79,116,148,69,38,136
"a/adrieje01","Jeff Adrien",961,327,362,35,275,286,0,0,52,76,147,180,128,106,119
"a/adrieje01","Jeff Adrien",256,327,362,35,275,286,0,0,52,76,147,180,128,106,119
"a/adrieje01","Jeff Adrien",705,327,362,35,275,286,0,0,52,76,147,180,128,106,119
"a/afflaar01","Arron Afflalo",2552,1149,1315,166,711,672,300,384,138,259,146,180,565,492,336
"a/ajincal01","Alexis Ajinca",951,280,328,48,249,272,1,0,30,56,110,140,139,132,67
"a/aldrico01","Cole Aldrich",330,75,92,17,61,66,0,0,14,26,25,36,36,30,30
"a/aldrila01","LaMarcus Aldridge",2498,1584,1603,19,1408,1298,15,9,161,296,241,336,1167,962,360
"a/allenla01","Lavoy Allen",1072,324,303,-21,287,264,13,6,24,33,73,82,214,182,50
"a/allenla01","Lavoy Allen",960,324,303,-21,287,264,13,6,24,33,73,82,214,182,50
"a/allenla01","Lavoy Allen",112,324,303,-21,287,264,13,6,24,33,73,82,214,182,50
"a/allenra02","Ray Allen",1936,583,676,93,235,248,308,348,40,80,81,102,154,146,116
"a/allento01","Tony Allen",1278,466,495,29,366,386,47,33,53,76,215,282,151,104,121
"a/aminual01","Al-Farouq Aminu",2045,555,572,17,445,442,48,39,62,91,201,270,244,172,137
"a/amundlo01","Lou Amundson",185,44,38,-6,32,32,0,0,12,6,19,26,13,6,24
"a/amundlo01","Lou Amundson",184,44,38,-6,32,32,0,0,12,6,19,26,13,6,24
"a/anderch01","Chris Andersen",1396,353,477,124,263,348,12,9,78,120,206,312,57,36,169
"a/anderal01","Alan Anderson",1773,535,564,29,237,220,248,252,50,92,81,110,156,110,118
"a/anderja01","James Anderson",2309,762,808,46,366,388,351,345,45,75,198,270,168,118,106
"a/anderry01","Ryan Anderson",795,378,428,50,190,176,164,201,24,51,53,56,137,120,62
"a/antetgi01","Giannis Antetokounmpo",1897,514,525,11,300,264,118,123,96,138,189,222,111,42,202
"a/anthoca01","Carmelo Anthony",2982,1868,2078,210,1228,1152,415,501,225,425,278,340,950,812,541
"a/anthojo01","Joel Anthony",186,36,28,-8,32,24,0,0,4,4,8,8,24,16,8
"a/anthojo01","Joel Anthony",149,36,28,-8,32,24,0,0,4,4,8,8,24,16,8
"a/anticpe01","Pero Antic",925,325,352,27,123,134,171,168,31,50,60,82,63,52,66
"a/arizatr01","Trevor Ariza",2723,936,1102,166,411,418,442,540,83,144,200,262,211,156,193
"a/arthuda01","Darrell Arthur",1161,438,401,-37,346,276,64,72,28,53,51,54,295,222,62
"a/asikom01","Omer Asik",968,249,280,31,190,202,0,0,59,78,133,170,57,32,126
"a/augusdj01","D.J. Augustin",1939,810,910,100,386,330,332,399,92,181,144,160,242,170,227
"a/augusdj01","D.J. Augustin",1857,810,910,100,386,330,332,399,92,181,144,160,242,170,227
"a/ayongu01","Gustavo Ayon",429,112,112,0,102,104,0,0,10,8,62,70,40,34,20
"p/pendeje02","Jeff Ayres",952,199,240,41,174,202,0,0,25,38,103,150,71,52,55
"b/babbch01","Chris Babb",132,30,22,-8,3,4,27,18,0,0,1,2,2,2,0
"b/babbilu01","Luke Babbitt",473,163,170,7,59,48,95,108,9,14,8,10,51,38,18
"b/barbole01","Leandro Barbosa",368,148,150,2,106,98,25,21,17,31,49,64,57,34,39
"b/bareajo01","J.J. Barea",1471,697,656,-41,425,362,231,219,41,75,170,180,255,182,100
"b/bargnan01","Andrea Bargnani",1257,548,558,10,394,384,108,90,46,84,91,112,303,272,102
"b/barneha02","Harrison Barnes",2204,763,738,-25,488,410,190,198,85,130,134,166,354,244,181
"b/barnema02","Matt Barnes",1735,569,625,56,244,268,283,291,42,66,107,150,137,118,90
"b/bartowi01","Will Barton",387,171,166,-5,123,110,33,30,15,26,52,74,71,36,32
"b/bassbr01","Brandon Bass",2266,832,907,75,719,700,6,6,107,201,232,292,487,408,239
"b/battish01","Shane Battier",1468,285,298,13,65,64,210,219,10,15,25,34,40,30,23
"b/batumni01","Nicolas Batum",2956,909,1069,160,417,472,402,435,90,162,171,266,246,206,203
"b/bayleje01","Jerryd Bayless",1686,663,654,-9,404,344,213,228,46,82,72,78,332,266,118
"b/bayleje01","Jerryd Bayless",650,663,654,-9,404,344,213,228,46,82,72,78,332,266,118
"b/bayleje01","Jerryd Bayless",1036,663,654,-9,404,344,213,228,46,82,72,78,332,266,118
"b/baynear01","Aron Baynes",491,172,161,-11,163,142,0,0,9,19,68,78,95,64,21
"b/bazemke01","Kent Bazemore",911,395,403,8,215,208,128,129,52,66,81,112,134,96,109
"b/bazemke01","Kent Bazemore",268,395,403,8,215,208,128,129,52,66,81,112,134,96,109
"b/bazemke01","Kent Bazemore",643,395,403,8,215,208,128,129,52,66,81,112,134,96,109
"b/bealbr01","Bradley Beal",2530,1227,1238,11,806,686,343,414,78,138,156,200,650,486,189
"b/beaslmi01","Michael Beasley",831,389,436,47,301,312,54,63,34,61,101,136,200,176,79
"b/belinma01","Marco Belinelli",2016,745,903,158,402,422,293,378,50,103,116,174,286,248,131
"b/bennean01","Anthony Bennett",663,258,217,-41,172,134,53,39,33,44,61,74,111,60,69
"b/beverpa01","Patrick Beverley",1751,526,569,43,226,214,255,276,45,79,81,92,145,122,102
"b/billuch01","Chauncey Billups",309,85,72,-13,31,20,48,42,6,10,3,2,28,18,12
"b/biyombi01","Bismack Biyombo",1072,184,222,38,144,176,0,0,40,46,89,136,55,40,89
"b/blairde01","DeJuan Blair",1214,445,497,52,391,420,2,0,52,77,171,222,220,198,121
"b/blakest01","Steve Blake",1498,372,378,6,143,108,210,237,19,33,22,28,121,80,43
"b/blakest01","Steve Blake",891,372,378,6,143,108,210,237,19,33,22,28,121,80,43
"b/blakest01","Steve Blake",607,372,378,6,143,108,210,237,19,33,22,28,121,80,43
"b/blatcan01","Andray Blatche",1618,772,821,49,620,612,54,45,98,164,227,310,393,302,221
"b/bledser01","Eric Bledsoe",1416,656,752,96,416,430,140,150,100,172,173,234,243,196,237
"b/bogutan01","Andrew Bogut",1769,404,492,88,375,470,0,0,29,22,245,344,130,126,64
"b/bonnema01","Matt Bonner",690,170,197,27,66,62,98,126,6,9,7,10,59,52,12
"b/booketr01","Trevor Booker",1553,436,491,55,401,444,2,0,33,47,156,232,245,212,76
"b/boozeca01","Carlos Boozer",2141,1068,1042,-26,978,894,2,0,88,148,285,376,693,518,193
"b/boshch01","Chris Bosh",2531,1075,1279,204,735,836,218,222,122,221,248,360,487,476,272
"b/bradlav01","Avery Bradley",1855,874,890,16,625,564,200,237,49,89,143,180,482,384,112
"b/brandel01","Elton Brand",1414,374,419,45,330,358,2,0,42,61,76,110,254,248,94
"b/breweco01","Corey Brewer",2609,905,998,93,596,658,211,177,98,163,348,488,248,170,227
"b/brewero02","Ronnie Brewer",160,16,7,-9,7,4,8,3,1,0,3,4,4,0,2
"b/brewero02","Ronnie Brewer",158,16,7,-9,7,4,8,3,1,0,3,4,4,0,2
"b/brookaa01","Aaron Brooks",1557,624,643,19,333,274,248,288,43,81,97,96,236,178,95
"b/brookaa01","Aaron Brooks",716,624,643,19,333,274,248,288,43,81,97,96,236,178,95
"b/brookaa01","Aaron Brooks",841,624,643,19,333,274,248,288,43,81,97,96,236,178,95
"b/brookma01","MarShon Brooks",316,145,159,14,100,88,25,39,20,32,31,40,69,48,44
"b/brookma01","MarShon Brooks",228,145,159,14,100,88,25,39,20,32,31,40,69,48,44
"b/brownlo01","Lorenzo Brown",224,92,64,-28,56,46,30,9,6,9,25,22,31,24,13
"b/brownsh01","Shannon Brown",251,76,63,-13,64,48,2,0,10,15,22,36,42,12,21
"b/brownsh01","Shannon Brown",103,76,63,-13,64,48,2,0,10,15,22,36,42,12,21
"b/brownsh01","Shannon Brown",148,76,63,-13,64,48,2,0,10,15,22,36,42,12,21
"b/bryanko01","Kobe Bryant",177,82,82,0,57,56,16,9,9,17,10,16,47,40,21
"b/budinch01","Chase Budinger",751,272,274,2,134,116,120,126,18,32,50,72,84,44,39
"b/bullore01","Reggie Bullock",395,125,115,-10,48,42,73,66,4,7,9,16,39,26,9
"b/burketr01","Trey Burke",2262,940,879,-61,561,460,336,333,43,86,109,114,452,346,113
"b/burksal01","Alec Burks",2193,995,1087,92,688,660,143,150,164,277,257,344,431,316,373
"b/butleca01","Caron Butler",1419,570,583,13,291,230,249,294,30,59,35,34,256,196,75
"b/butleca01","Caron Butler",821,570,583,13,291,230,249,294,30,59,35,34,256,196,75
"b/butleca01","Caron Butler",598,570,583,13,291,230,249,294,30,59,35,34,256,196,75
"b/butleji01","Jimmy Butler",2591,849,878,29,453,414,240,204,156,260,182,222,271,192,338
"b/butlera01","Rasual Butler",378,117,136,19,48,50,62,78,7,8,16,22,32,28,14
"b/buyckdw01","Dwight Buycks",146,51,43,-8,31,20,17,15,3,8,7,10,24,10,9
"b/bynuman01","Andrew Bynum",516,246,225,-21,225,188,0,0,21,37,68,72,157,116,49
"b/bynuman01","Andrew Bynum",480,246,225,-21,225,188,0,0,21,37,68,72,157,116,49
"b/bynumwi01","Will Bynum",1054,480,484,4,367,328,62,60,51,96,132,166,235,162,121
"c/calatni01","Nick Calathes",1173,341,347,6,250,246,61,57,30,44,99,130,151,116,72
"c/caldejo01","Jose Calderon",2468,774,917,143,323,300,425,573,26,44,60,88,263,212,63
"c/caldwke01","Kentavious Caldwell-Pope",1583,485,470,-15,275,246,185,177,25,47,114,144,161,102,61
"c/canaais01","Isaiah Canaan",252,101,101,0,31,26,56,54,14,21,14,14,17,12,29
"c/carrode01","DeMarre Carroll",2341,703,810,107,374,410,268,291,61,109,179,254,195,156,141
"c/cartevi01","Vince Carter",1973,900,964,64,440,368,371,438,89,158,134,146,306,222,196
"c/cartemi01","Michael Carter-Williams",2414,1218,1166,-52,846,744,208,165,164,257,319,368,527,376,367
"c/casspom01","Omri Casspi",1283,466,488,22,233,224,176,183,57,81,72,106,161,118,122
"c/chalmma01","Mario Chalmers",2178,629,709,80,334,334,226,261,69,114,177,212,157,122,163
"c/chandty01","Tyson Chandler",1662,390,480,90,321,382,1,0,68,98,232,328,89,54,155
"c/chandwi01","Wilson Chandler",1927,806,846,40,387,370,351,366,68,110,130,178,257,192,152
"c/chrisdi01","Dionte Christmas",198,74,71,-3,31,26,31,27,12,18,11,14,20,12,24
"c/clarkea01","Earl Clark",768,277,257,-20,139,112,122,123,16,22,40,44,99,68,34
"c/clarkea01","Earl Clark",698,277,257,-20,139,112,122,123,16,22,40,44,99,68,34
"c/clarkia01","Ian Clark",172,70,68,-2,36,30,31,33,3,5,9,12,27,18,7
"c/clavevi01","Victor Claver",184,47,47,0,24,28,18,9,5,10,15,24,9,4,11
"c/coleno01","Norris Cole",2014,529,526,-3,326,294,174,180,29,52,149,160,177,134,68
"c/collija04","Jason Collins",172,25,25,0,21,22,3,0,1,3,8,12,13,10,4
"c/collida01","Darren Collison",2069,789,902,113,505,506,189,213,95,183,152,208,353,298,224
"c/collini01","Nick Collison",1353,284,338,54,224,260,17,12,43,66,131,176,93,84,93
"c/conlemi01","Mike Conley",2446,1148,1243,95,739,716,291,315,118,212,243,300,496,416,276
"c/copelch01","Chris Copeland",265,123,153,30,38,44,79,99,6,10,17,22,21,22,14
"c/couside01","DeMarcus Cousins",2298,1447,1613,166,1184,1182,7,0,256,431,347,476,837,706,595
"c/crabbal01","Allen Crabbe",100,34,32,-2,19,12,14,18,1,2,7,6,12,6,4
"c/crawfja01","Jamal Crawford",2094,1140,1273,133,565,520,446,483,129,270,92,118,473,402,322
"c/crawfjo02","Jordan Crawford",1859,853,869,16,503,474,285,270,65,125,89,104,414,370,169
"c/crawfjo02","Jordan Crawford",1198,853,869,16,503,474,285,270,65,125,89,104,414,370,169
"c/crawfjo02","Jordan Crawford",661,853,869,16,503,474,285,270,65,125,89,104,414,370,169
"c/crowdja01","Jae Crowder",1254,323,356,33,145,160,151,150,27,46,68,102,77,58,61
"c/cunnida01","Dante Cunningham",1635,539,512,-27,504,474,6,0,29,38,106,150,398,324,67
"c/curryst01","Stephen Curry",2846,1518,1845,327,768,782,615,783,135,280,169,218,599,564,348
"d/dalemsa01","Samuel Dalembert",1614,441,529,88,376,428,1,0,64,101,240,320,136,108,137
"d/datomlu01","Luigi Datome",238,102,83,-19,58,54,39,21,5,8,13,20,45,34,10
"d/daviebr01","Brandon Davies",575,151,144,-7,118,104,10,6,23,34,54,64,64,40,53
"d/davisan02","Anthony Davis",2358,1202,1392,190,996,1040,9,6,197,346,348,506,648,534,440
"d/davised01","Ed Davis",956,329,357,28,290,310,0,0,39,47,139,200,151,110,89
"d/davisgl01","Glen Davis",1662,654,641,-13,582,534,11,12,61,95,145,178,437,356,137
"d/davisgl01","Glen Davis",1354,654,641,-13,582,534,11,12,61,95,145,178,437,356,137
"d/davisgl01","Glen Davis",308,654,641,-13,582,534,11,12,61,95,145,178,437,356,137
"d/dayeau01","Austin Daye",148,72,66,-6,31,24,37,36,4,6,8,12,23,12,10
"d/dayeau01","Austin Daye",115,72,66,-6,31,24,37,36,4,6,8,12,23,12,10
"d/decolna01","Nando De Colo",494,169,177,8,100,92,53,54,16,31,39,50,61,42,35
"d/decolna01","Nando De Colo",301,169,177,8,100,92,53,54,16,31,39,50,61,42,35
"d/decolna01","Nando De Colo",193,169,177,8,100,92,53,54,16,31,39,50,61,42,35
"d/dedmode01","Dewayne Dedmon",390,97,97,0,83,76,0,0,14,21,42,50,41,26,32
"d/dedmode01","Dewayne Dedmon",150,97,97,0,83,76,0,0,14,21,42,50,41,26,32
"d/dedmode01","Dewayne Dedmon",234,97,97,0,83,76,0,0,14,21,42,50,41,26,32
"d/dellama01","Matthew Dellavedova",1271,318,337,19,142,130,154,171,22,36,26,36,116,94,48
"d/denglu01","Luol Deng",2213,980,1010,30,671,628,189,171,120,211,208,274,463,354,268
"d/denglu01","Luol Deng",860,980,1010,30,671,628,189,171,120,211,208,274,463,354,268
"d/denglu01","Luol Deng",1353,980,1010,30,671,628,189,171,120,211,208,274,463,354,268
"d/derozde01","DeMar DeRozan",3017,1679,1768,89,1197,1080,210,192,272,496,180,262,1017,818,630
"d/diawbo01","Boris Diaw",1974,619,717,98,468,514,112,135,39,68,162,228,306,286,92
"d/dienggo01","Gorgui Dieng",818,270,286,16,226,224,1,3,43,59,114,142,112,82,93
"d/douglto01","Toney Douglas",675,205,201,-4,88,84,102,93,15,24,41,52,47,32,34
"d/douglto01","Toney Douglas",265,205,201,-4,88,84,102,93,15,24,41,52,47,32,34
"d/douglto01","Toney Douglas",410,205,201,-4,88,84,102,93,15,24,41,52,47,32,34
"d/douglch01","Chris Douglas-Roberts",1016,286,339,53,120,120,132,153,34,66,66,86,54,34,82
"d/dragigo01","Goran Dragic",2668,1269,1522,253,794,860,299,366,176,296,355,504,439,356,416
"d/drumman01","Andre Drummond",2619,919,1095,176,767,958,2,0,150,137,607,836,160,122,328
"d/dudleja01","Jared Dudley",1729,473,511,38,222,230,225,243,26,38,34,46,188,184,58
"d/duncati01","Tim Duncan",2158,1046,1118,72,900,888,5,0,141,230,264,366,636,522,316
"d/dunlemi02","Mike Dunleavy",2584,839,909,70,450,420,324,369,65,120,121,152,329,268,164
"d/duranke01","Kevin Durant",3122,2026,2556,530,1197,1314,491,576,338,666,354,576,843,738,805
"e/ellinwa01","Wayne Ellington",393,130,144,14,67,60,59,75,4,9,14,28,53,32,11
"e/ellismo01","Monta Ellis",3023,1473,1559,86,1069,1014,209,207,195,338,371,460,698,554,430
"e/evansje01","Jeremy Evans",1209,364,401,37,330,350,2,0,32,51,143,200,187,150,75
"e/evansre01","Reggie Evans",899,213,214,1,150,142,0,0,63,72,67,82,83,60,130
"e/evansre01","Reggie Evans",399,213,214,1,150,142,0,0,63,72,67,82,83,60,130
"e/evansre01","Reggie Evans",500,213,214,1,150,142,0,0,63,72,67,82,83,60,130
"e/evansty01","Tyreke Evans",2028,1032,1041,9,802,740,95,63,135,238,443,500,359,240,310
"f/farieke01","Kenneth Faried",2178,958,1096,138,817,894,3,0,138,202,374,526,443,368,311
"f/farmajo01","Jordan Farmar",912,388,412,24,204,162,160,210,24,40,59,62,145,100,59
"f/favervi01","Vitor Faverani",488,165,164,-1,107,104,40,36,18,24,49,64,58,40,37
"f/favorde01","Derrick Favors",2201,866,970,104,746,780,1,0,119,190,323,466,423,314,284
"f/feltora01","Raymond Felton",2017,666,629,-37,413,356,195,186,58,87,132,152,281,204,122
"f/fieldla01","Landry Fields",322,76,68,-8,62,54,5,0,9,14,25,32,37,22,22
"f/fishede01","Derek Fisher",1428,392,425,33,132,106,229,264,31,55,21,20,111,86,71
"f/fournev01","Evan Fournier",1503,599,638,39,307,278,237,267,55,93,120,152,187,126,123
"f/foyera01","Randy Foye",2485,949,1048,99,377,344,498,567,74,137,100,116,277,228,185
"f/frankja01","Jamaal Franklin",161,40,39,-1,28,22,11,15,1,2,10,14,18,8,2
"f/fredeji01","Jimmer Fredette",519,236,272,36,143,134,84,120,9,18,19,28,124,106,21
"f/fredeji01","Jimmer Fredette",463,236,272,36,143,134,84,120,9,18,19,28,124,106,21
"f/freeljo01","Joel Freeland",727,174,174,0,159,154,2,0,13,20,61,76,98,78,29
"f/fryech01","Channing Frye",2312,821,909,88,345,352,433,480,43,77,83,104,262,248,95
"g/garcifr01","Francisco Garcia",1083,303,315,12,101,98,193,207,9,10,45,62,56,36,19
"g/garneke01","Kevin Garnett",1109,377,352,-25,353,314,3,0,21,38,53,64,300,250,47
"g/garredi02","Diante Garrett",1048,271,248,-23,169,130,96,108,6,10,36,44,133,86,12
"g/gasolma01","Marc Gasol",1970,817,859,42,700,668,11,6,106,185,118,178,582,490,241
"g/gasolpa01","Pau Gasol",1884,997,1041,44,871,842,14,12,112,187,197,266,674,576,254
"g/gayru01","Rudy Gay",2531,1351,1447,96,982,944,197,195,172,308,253,356,729,588,387
"g/gayru01","Rudy Gay",639,1351,1447,96,982,944,197,195,172,308,253,356,729,588,387
"g/gayru01","Rudy Gay",1892,1351,1447,96,982,944,197,195,172,308,253,356,729,588,387
"g/geeal01","Alonzo Gee",1020,266,258,-8,178,158,59,57,29,43,90,112,88,46,61
"g/georgpa01","Paul George",2898,1552,1705,153,861,788,500,546,191,371,261,324,600,464,464
"g/gibsota01","Taj Gibson",2351,1022,1069,47,889,858,7,0,126,211,297,398,592,460,281
"g/ginobma01","Manu Ginobili",1550,707,827,120,369,408,258,270,80,149,163,236,206,172,188
"g/goberru01","Rudy Gobert",434,104,104,0,74,72,0,0,30,32,44,60,30,12,65
"g/goodedr01","Drew Gooden",395,155,183,28,125,138,18,21,12,24,40,58,85,80,27
"g/goodwar01","Archie Goodwin",533,190,194,4,131,142,36,15,23,37,81,106,50,36,55
"g/gordobe01","Ben Gordon",279,116,95,-21,79,58,29,24,8,13,17,20,62,38,21
"g/gordoer01","Eric Gordon",2057,918,987,69,558,510,258,303,102,174,208,268,350,242,223
"g/gortama01","Marcin Gortat",2655,939,1068,129,839,908,1,3,99,157,299,466,540,442,229
"g/grangda01","Danny Granger",847,336,336,0,179,146,128,129,29,61,57,66,122,80,67
"g/grangda01","Danny Granger",653,336,336,0,179,146,128,129,29,61,57,66,122,80,67
"g/grangda01","Danny Granger",194,336,336,0,179,146,128,129,29,61,57,66,122,80,67
"g/grayaa01","Aaron Gray",355,71,65,-6,60,54,1,0,10,11,20,22,40,32,20
"g/grayaa01","Aaron Gray",335,71,65,-6,60,54,1,0,10,11,20,22,40,32,20
"g/greenda02","Danny Green",1651,529,616,87,187,172,318,396,24,48,56,80,131,92,63
"g/greendr01","Draymond Green",1797,519,511,-8,294,264,165,165,60,82,124,154,170,110,123
"g/greenge01","Gerald Green",2330,1106,1287,181,496,488,510,612,100,187,135,190,361,298,230
"g/greenje02","Jeff Green",2805,1324,1374,50,775,694,396,405,153,275,250,334,525,360,356
"g/greenwi01","Willie Green",869,288,273,-15,150,122,121,123,17,28,30,38,120,84,34
"g/griffbl01","Blake Griffin",2863,1658,1930,272,1315,1412,44,36,299,482,476,714,839,698,674
"g/gutiejo01","Jorge Gutierrez",244,60,62,2,42,44,12,9,6,9,16,26,26,18,12
"h/hamiljo02","Jordan Hamilton",1019,398,404,6,178,154,197,210,23,40,57,62,121,92,51
"h/hamiljo02","Jordan Hamilton",670,398,404,6,178,154,197,210,23,40,57,62,121,92,51
"h/hamiljo02","Jordan Hamilton",349,398,404,6,178,154,197,210,23,40,57,62,121,92,51
"h/hansbty01","Tyler Hansbrough",978,278,312,34,194,186,2,0,82,126,88,102,106,84,185
"h/hardati02","Tim Hardaway",1875,737,819,82,329,328,358,390,50,101,130,180,199,148,128
"h/hardeja01","James Harden",2777,1487,1824,337,722,744,483,531,282,549,282,360,440,384,665
"h/harklma01","Maurice Harkless",1950,547,592,45,329,330,154,177,64,85,205,244,124,86,143
"h/harrejo01","Josh Harrellson",317,85,93,8,51,52,31,36,3,5,33,36,18,16,7
"h/harrial01","Al Harrington",511,222,225,3,107,96,100,102,15,27,60,70,47,26,35
"h/harride01","Devin Harris",818,303,314,11,153,130,101,93,49,91,60,66,93,64,115
"h/harrima01","Manny Harris",180,73,73,0,50,42,20,21,3,10,20,28,30,14,12
"h/harrimi01","Mike Harris",225,74,84,10,59,58,2,0,13,26,13,24,46,34,27
"h/harrito02","Tobias Harris",1850,820,892,72,590,600,126,96,104,196,188,276,402,324,244
"h/hasleud01","Udonis Haslem",653,165,173,8,146,148,0,0,19,25,70,92,76,56,44
"h/hawessp01","Spencer Hawes",2470,949,1050,101,575,550,307,384,67,116,227,282,348,268,152
"h/hawessp01","Spencer Hawes",1666,949,1050,101,575,550,307,384,67,116,227,282,348,268,152
"h/hawessp01","Spencer Hawes",804,949,1050,101,575,550,307,384,67,116,227,282,348,268,152
"h/hayesch01","Chuck Hayes",754,140,132,-8,129,112,1,0,10,20,46,52,83,60,25
"h/hayesch01","Chuck Hayes",179,140,132,-8,129,112,1,0,10,20,46,52,83,60,25
"h/hayesch01","Chuck Hayes",575,140,132,-8,129,112,1,0,10,20,46,52,83,60,25
"h/haywago01","Gordon Hayward",2800,1196,1235,39,752,682,280,255,164,298,184,250,568,432,381
"h/hendege02","Gerald Henderson",2461,1068,1072,4,815,726,115,120,138,226,171,214,644,512,309
"h/henryxa01","Xavier Henry",908,425,432,7,264,232,81,84,80,116,96,112,168,120,177
"h/hensojo01","John Henson",1856,721,779,58,638,688,1,0,82,91,266,370,372,318,177
"h/hibbero01","Roy Hibbert",2409,873,871,-2,749,658,5,6,119,207,167,188,582,470,269
"h/hicksjj01","J.J. Hickson",1859,785,814,29,646,664,8,0,131,150,280,406,366,258,290
"h/hilarne01","Nene Hilario",1560,714,754,40,589,596,5,3,120,155,203,284,386,312,266
"h/hillge01","George Hill",2434,692,777,85,356,354,260,285,76,138,93,132,263,222,176
"h/hilljo01","Jordan Hill",1500,599,696,97,520,572,1,0,78,124,188,256,332,316,181
"h/hillso01","Solomon Hill",226,43,47,4,17,20,23,21,3,6,8,8,9,12,7
"h/hinriki01","Kirk Hinrich",2116,677,663,-14,377,316,242,255,58,92,71,76,306,240,125
"h/holidjr01","Jrue Holiday",1143,481,485,4,377,346,77,90,27,49,106,118,271,228,63
"h/holliry01","Ryan Hollins",482,97,141,44,72,106,0,0,25,35,42,78,30,28,56
"h/horfoal01","Al Horford",958,460,538,78,409,468,11,12,40,58,120,184,289,284,85
"h/howardw01","Dwight Howard",2396,1095,1297,202,793,942,7,6,295,349,405,628,388,314,638
"h/hummero01","Robbie Hummel",655,184,180,-4,88,70,89,96,7,14,11,18,77,52,16
"h/humphkr01","Kris Humphries",1376,529,579,50,459,462,3,0,67,117,125,164,334,298,144
"i/ibakase01","Serge Ibaka",2666,1068,1227,159,918,1002,60,69,90,156,289,436,629,566,199
"i/iguodan01","Andre Iguodala",2040,518,588,70,283,316,175,186,60,86,122,174,161,142,132
"i/ilyaser01","Ersan Ilyasova",1478,640,618,-22,448,400,131,111,61,107,155,176,293,224,130
"i/irvinky01","Kyrie Irving",2496,1370,1450,80,893,818,344,369,133,263,275,326,618,492,338
"j/jackja01","Jarrett Jack",2252,760,750,-10,513,446,185,189,62,115,53,66,460,380,149
"j/jacksre01","Reggie Jackson",2277,996,1042,46,671,640,245,249,80,153,243,292,428,348,177
"j/jacksst02","Stephen Jackson",107,28,15,-13,12,10,14,3,2,2,4,4,8,6,4
"j/jamesbe01","Bernard James",146,26,28,2,22,22,1,0,3,6,15,16,7,6,11
"j/jamesle01","LeBron James",2902,1600,2077,477,1047,1302,306,348,247,427,507,812,540,490,585
"j/jamisan01","Antawn Jamison",248,103,84,-19,51,42,41,24,11,18,20,24,31,18,25
"j/jeffeal01","Al Jefferson",2553,1495,1594,99,1361,1394,15,9,119,191,348,480,1013,914,277
"j/jefferi01","Richard Jefferson",2213,723,830,107,353,342,301,369,69,119,122,178,231,164,162
"j/jenkijo01","John Jenkins",158,43,40,-3,24,24,18,12,1,4,15,14,9,10,4
"j/jennibr01","Brandon Jennings",2728,1268,1229,-39,678,538,457,462,133,229,225,250,453,288,321
"j/jerebjo01","Jonas Jerebko",741,234,270,36,134,134,74,93,26,43,65,88,69,46,59
"j/johnsam01","Amir Johnson",2214,673,799,126,546,648,66,60,61,91,232,336,314,312,143
"j/johnsch04","Chris Johnson",789,233,249,16,87,84,127,129,19,36,45,54,42,30,43
"j/johnsja01","James Johnson",956,349,384,35,221,242,87,66,41,76,134,174,87,68,90
"j/johnsjo02","Joe Johnson",2575,1101,1236,135,614,600,404,486,83,150,60,84,554,516,195
"j/johnsor01","Orlando Johnson",392,125,100,-25,66,54,47,27,12,19,20,18,46,36,26
"j/johnsor01","Orlando Johnson",342,125,100,-25,66,54,47,27,12,19,20,18,46,36,26
"j/johnswe01","Wesley Johnson",2240,685,715,30,380,354,271,300,34,61,138,184,242,170,77
"j/jonesja02","James Jones",236,73,97,24,14,6,54,84,5,7,3,2,11,4,11
"j/jonespe01","Perry Jones",764,201,216,15,120,122,61,66,20,28,43,60,77,62,42
"j/joneste01","Terrence Jones",2078,795,921,126,611,710,102,93,82,118,321,486,290,224,195
"j/jordade01","DeAndre Jordan",2870,687,856,169,515,696,0,0,172,160,365,536,150,160,374
"j/josepco01","Cory Joseph",936,309,343,34,227,228,38,36,44,79,73,94,154,134,96
"k/kamanch01","Chris Kaman",736,377,404,27,343,352,3,0,31,52,79,116,264,236,68
"k/kanteen01","Enes Kanter",2138,945,987,42,852,838,1,0,92,149,299,392,553,446,204
"k/karasse01","Sergey Karasev",156,40,37,-3,16,16,19,12,5,9,4,8,12,8,10
"k/kellyry01","Ryan Kelly",1312,427,472,45,229,218,142,144,56,110,66,84,163,134,135
"k/kiddgmi01","Michael Kidd-Gilchrist",1502,436,448,12,344,332,9,3,83,113,192,246,152,86,184
"k/kirilan01","Andrei Kirilenko",857,215,226,11,155,162,5,3,55,61,87,116,68,46,119
"k/knighbr03","Brandon Knight",2400,1235,1283,48,754,702,338,330,143,251,304,358,450,344,323
"k/korveky01","Kyle Korver",2408,632,824,192,217,208,392,555,23,61,12,14,205,194,94
"k/koufoko01","Kosta Koufos",1349,500,514,14,459,454,0,0,41,60,200,240,259,214,93
"l/lambdo01","Doron Lamb",695,174,189,15,70,54,90,108,14,27,11,8,59,46,36
"l/lambje01","Jeremy Lamb",1538,636,665,29,362,350,247,264,27,51,94,136,268,214,64
"l/landrca01","Carl Landry",233,66,76,10,60,62,0,0,6,14,12,20,48,42,17
"l/larkish01","Shane Larkin",489,147,132,-15,99,80,38,36,10,16,22,26,77,54,25
"l/lawsoty01","Ty Lawson",2222,991,1089,98,604,550,202,216,185,323,182,218,422,332,406
"l/leeco01","Courtney Lee",1973,655,748,93,420,446,194,216,41,86,107,142,313,304,112
"l/leeco01","Courtney Lee",504,655,748,93,420,446,194,216,41,86,107,142,313,304,112
"l/leeco01","Courtney Lee",1469,655,748,93,420,446,194,216,41,86,107,142,313,304,112
"l/leeda02","David Lee",2288,1115,1257,142,980,1026,1,0,134,231,405,566,575,460,296
"l/lenal01","Alex Len",362,92,86,-6,78,66,0,0,14,20,34,42,44,24,31
"l/leonaka01","Kawhi Leonard",1923,697,844,147,463,536,182,207,52,101,180,256,283,280,126
"l/leoname01","Meyers Leonard",355,100,98,-2,85,82,6,0,9,16,25,32,60,50,21
"l/leuerjo01","Jon Leuer",642,268,302,34,197,196,49,69,22,37,58,78,139,118,47
"l/lewisra02","Rashard Lewis",971,250,268,18,102,104,134,138,14,26,29,44,73,60,33
"l/lillada01","Damian Lillard",2937,1479,1660,181,750,670,554,654,175,336,351,366,399,304,426
"l/linje01","Jeremy Lin",2054,784,886,102,433,426,229,246,122,214,167,218,266,208,265
"l/livinsh01","Shaun Livingston",1974,573,627,54,481,468,6,3,86,156,157,186,324,282,191
"l/lopezbr01","Brook Lopez",533,280,352,72,228,258,1,0,51,94,66,90,162,168,115
"l/lopezro01","Robin Lopez",2603,755,908,153,643,710,1,0,111,198,343,458,300,252,242
"l/loveke01","Kevin Love",2797,1704,1993,289,917,920,505,570,282,503,331,446,586,474,633
"l/lowryky01","Kyle Lowry",2862,1247,1409,162,581,534,499,570,167,305,160,192,421,342,385
"l/lucasjo02","John Lucas III",591,194,155,-39,106,74,84,75,4,6,14,20,92,54,16
"m/macksh01","Shelvin Mack",1490,534,540,6,317,294,184,186,33,60,110,138,207,156,74
"m/mahinia01","Ian Mahinmi",1248,254,272,18,188,182,1,0,65,90,111,126,77,56,145
"m/mariosh01","Shawn Marion",2409,739,790,51,546,566,162,174,31,50,208,292,338,274,65
"m/marshke01","Kendall Marshall",1564,433,430,-3,241,198,178,213,14,19,83,88,158,110,36
"m/martica01","Cartier Martin",870,292,329,37,113,104,151,177,28,48,37,46,76,58,65
"m/martica01","Cartier Martin",822,292,329,37,113,104,151,177,28,48,37,46,76,58,65
"m/martike01","Kenyon Martin",633,132,137,5,122,126,1,0,9,11,62,86,60,40,19
"m/martike02","Kevin Martin",2177,1166,1272,106,726,650,297,345,143,277,190,250,536,400,340
"m/masonro01","Roger Mason",260,69,72,3,19,16,48,51,2,5,3,0,16,16,7
"m/matthwe02","Wesley Matthews",2780,1143,1341,198,499,488,510,603,134,250,165,226,334,262,301
"m/maxieja01","Jason Maxiell",488,119,109,-10,105,94,0,0,14,15,22,20,83,74,31
"m/maynoer01","Eric Maynor",327,106,82,-24,64,40,37,36,5,6,5,8,59,32,11
"m/maynoer01","Eric Maynor",215,106,82,-24,64,40,37,36,5,6,5,8,59,32,11
"m/maynoer01","Eric Maynor",112,106,82,-24,64,40,37,36,5,6,5,8,59,32,11
"m/mayooj01","O.J. Mayo",1346,586,602,16,323,280,227,252,36,70,75,80,248,200,88
"m/mbahalu01","Luc Mbah a Moute",1003,223,224,1,176,166,17,12,30,46,98,108,78,58,67
"m/mbahalu01","Luc Mbah a Moute",196,223,224,1,176,166,17,12,30,46,98,108,78,58,67
"m/mbahalu01","Luc Mbah a Moute",807,223,224,1,176,166,17,12,30,46,98,108,78,58,67
"m/mccalra01","Ray McCallum",897,318,278,-40,240,182,60,66,18,30,50,62,190,120,43
"m/mccolcj01","CJ McCollum",476,194,201,7,98,88,80,90,16,23,22,20,76,68,34
"m/mclembe01","Ben McLemore",2187,740,715,-25,383,320,296,285,61,110,126,162,257,158,143
"m/mcrobjo01","Josh McRoberts",2360,605,661,56,275,284,291,315,39,62,135,178,140,106,85
"m/meeksjo01","Jodie Meeks",2556,994,1195,201,488,502,404,486,102,207,213,298,275,204,258
"m/mekelga01","Gal Mekel",292,92,73,-19,66,50,20,15,6,8,17,24,49,26,12
"m/middlkh01","Khris Middleton",2460,915,985,70,564,512,290,360,61,113,137,154,427,358,137
"m/milescj01","C.J. Miles",984,441,501,60,198,190,211,249,32,62,64,80,134,110,75
"m/millean02","Andre Miller",982,265,281,16,210,190,21,33,34,58,70,82,140,108,77
"m/millean02","Andre Miller",570,265,281,16,210,190,21,33,34,58,70,82,140,108,77
"m/millean02","Andre Miller",412,265,281,16,210,190,21,33,34,58,70,82,140,108,77
"m/milleda01","Darius Miller",723,179,198,19,89,96,77,75,13,27,5,8,84,88,36
"m/millemi01","Mike Miller",1707,463,567,104,210,212,233,321,20,34,44,64,166,148,56
"m/millequ01","Quincy Miller",789,281,257,-24,162,128,94,90,25,39,64,74,98,54,55
"m/millspa02","Patty Mills",1527,699,823,124,348,348,318,405,33,70,82,122,266,226,82
"m/millspa01","Paul Millsap",2482,1222,1328,106,835,814,212,228,175,286,325,410,510,404,391
"m/mohamna01","Nazr Mohammed",562,139,124,-15,126,108,0,0,13,16,48,56,78,52,30
"m/monrogr01","Greg Monroe",2690,1178,1249,71,1014,1008,1,0,163,241,498,646,516,362,367
"m/mooreet01","E'Twaun Moore",1506,483,494,11,295,276,161,171,27,47,86,98,209,178,68
"m/morrida01","Darius Morris",313,106,106,0,58,54,38,36,10,16,15,22,43,32,26
"m/morrida01","Darius Morris",193,106,106,0,58,54,38,36,10,16,15,22,43,32,26
"m/morrima03","Marcus Morris",1800,721,794,73,391,378,260,297,70,119,96,126,295,252,159
"m/morrima02","Markieff Morris",2153,994,1112,118,737,754,108,102,149,256,224,298,513,456,327
"m/morroan01","Anthony Morrow",1426,549,619,70,325,300,195,264,29,55,38,48,287,252,87
"m/motiedo01","Donatas Motiejunas",952,339,341,2,212,220,84,63,43,58,69,88,143,132,96
"m/moultar01","Arnett Moultrie",187,40,36,-4,38,32,0,0,2,4,13,16,25,16,5
"m/mozgoti01","Timofey Mozgov",1770,664,770,106,521,562,24,12,119,196,276,362,245,200,260
"m/muhamsh01","Shabazz Muhammad",290,140,143,3,113,108,11,9,16,26,37,38,76,70,40
"m/mulleby01","Byron Mullens",414,175,189,14,76,80,89,99,10,10,31,46,45,34,20
"m/mulleby01","Byron Mullens",167,175,189,14,76,80,89,99,10,10,31,46,45,34,20
"m/mulleby01","Byron Mullens",247,175,189,14,76,80,89,99,10,10,31,46,45,34,20
"m/murryto01","Toure' Murry",373,147,140,-7,117,102,12,15,18,23,34,42,83,60,39
"m/muscami01","Mike Muscala",215,79,76,-3,70,62,3,0,6,14,21,20,49,42,14
"n/nashst01","Steve Nash",313,105,101,-4,70,56,24,24,11,21,8,8,62,48,24
"n/nealga01","Gary Neal",1114,515,544,29,291,250,180,204,44,90,32,38,259,212,105
"n/nealga01","Gary Neal",607,515,544,29,291,250,180,204,44,90,32,38,259,212,105
"n/nealga01","Gary Neal",507,515,544,29,291,250,180,204,44,90,32,38,259,212,105
"n/nedovne01","Nemanja Nedovic",142,43,26,-17,21,10,18,9,4,7,5,4,16,6,8
"n/nelsoja01","Jameer Nelson",2179,794,816,22,356,316,391,408,47,92,126,164,230,152,112
"n/nichoan01","Andrew Nicholson",1174,444,435,-9,331,304,89,84,24,47,49,70,282,234,57
"n/noahjo01","Joakim Noah",2820,952,1007,55,798,760,2,0,152,247,358,432,440,328,335
"n/novakst01","Steve Novak",540,147,176,29,24,16,122,156,1,4,0,0,24,16,6
"n/nowitdi01","Dirk Nowitzki",2628,1427,1709,282,944,1004,329,393,154,312,72,110,872,894,376
"n/nunnaja01","James Nunnally",165,50,44,-6,21,14,25,24,4,6,8,12,13,2,9
"n/nunnaja01","James Nunnally",111,50,44,-6,21,14,25,24,4,6,8,12,13,2,9
"o/onealje01","Jermaine O'Neal",883,307,349,42,248,250,0,0,59,99,86,124,162,126,132
"o/oquinky01","Kyle O'Quinn",1188,408,429,21,368,372,3,0,37,57,114,164,254,208,83
"o/odengr01","Greg Oden",212,58,67,9,49,54,0,0,9,13,34,48,15,6,23
"o/oladivi01","Victor Oladipo",2487,1081,1104,23,710,636,226,222,145,246,309,378,401,258,318
"o/olynyke01","Kelly Olynyk",1400,556,607,51,388,388,113,120,55,99,178,246,210,142,122
"o/ortonda01","Daniel Orton",251,59,65,6,47,42,0,0,12,23,19,20,28,22,30
"o/outlatr01","Travis Outlaw",1065,351,343,-8,209,178,117,123,25,42,28,36,181,142,52
"p/pachuza01","Zaza Pachulia",1325,410,408,-2,348,298,1,0,61,110,158,162,190,136,130
"p/pargoja01","Jannero Pargo",242,122,134,12,58,56,60,72,4,6,5,0,53,56,11
"p/parketo01","Tony Parker",1997,1021,1126,105,847,862,67,75,107,189,265,336,582,526,243
"p/parsoch01","Chandler Parsons",2783,1081,1226,145,636,672,351,390,94,164,285,380,351,292,221
"p/pattepa01","Patrick Patterson",1533,522,555,33,338,340,151,165,33,50,78,102,260,238,71
"p/pattepa01","Patrick Patterson",415,522,555,33,338,340,151,165,33,50,78,102,260,238,71
"p/pattepa01","Patrick Patterson",1118,522,555,33,338,340,151,165,33,50,78,102,260,238,71
"p/paulch01","Chris Paul",2171,1015,1154,139,657,656,213,234,145,264,83,124,574,532,345
"p/pekovni01","Nikola Pekovic",1663,810,942,132,700,756,0,0,110,186,347,454,353,302,249
"p/perkike01","Kendrick Perkins",1207,224,211,-13,192,174,1,0,31,37,69,76,123,98,67
"p/piercpa01","Paul Pierce",2098,843,996,153,412,418,300,336,131,242,140,182,272,236,310
"p/plumlma01","Mason Plumlee",1275,389,520,131,299,398,3,0,87,122,223,342,76,56,195
"p/plumlmi01","Miles Plumlee",1964,611,646,35,553,572,0,0,58,74,262,378,291,194,132
"p/pondequ01","Quincy Pondexter",270,90,94,4,45,40,34,33,11,21,19,22,26,18,26
"p/porteot01","Otto Porter",319,95,78,-17,70,58,21,12,4,8,16,22,54,36,12
"p/pressph01","Phil Pressey",1132,275,213,-62,147,100,106,84,22,29,51,52,96,48,45
"p/pricero01","Ronnie Price",377,98,74,-24,49,38,43,27,6,9,17,14,32,24,13
"p/prigipa01","Pablo Prigioni",1283,196,250,54,51,46,140,195,5,9,24,32,27,14,12
"p/princta01","Tayshaun Prince",1948,520,454,-66,423,360,69,60,28,34,83,130,340,230,60
"r/radulmi01","Miroslav Raduljica",465,151,181,30,126,136,0,0,25,45,69,94,57,42,55
"r/randoan01","Anthony Randolph",527,205,206,1,114,100,61,54,30,52,46,58,68,42,69
"r/randoza01","Zach Randolph",2705,1351,1372,21,1178,1116,20,6,153,250,369,426,809,690,337
"r/redicjj01","J.J. Redick",987,438,515,77,213,216,185,219,40,80,34,50,179,166,106
"r/ricegl02","Glen Rice",109,40,32,-8,20,12,17,15,3,5,8,10,12,2,7
"r/ridnolu01","Luke Ridnour",1141,339,306,-33,219,178,108,111,12,17,26,28,193,150,26
"r/ridnolu01","Luke Ridnour",763,339,306,-33,219,178,108,111,12,17,26,28,193,150,26
"r/ridnolu01","Luke Ridnour",378,339,306,-33,219,178,108,111,12,17,26,28,193,150,26
"r/riverau01","Austin Rivers",1339,551,530,-21,375,312,99,108,77,110,147,158,228,154,173
"r/roberan03","Andre Roberson",399,73,75,2,55,62,13,6,5,7,46,62,9,0,10
"r/roberbr01","Brian Roberts",1667,634,665,31,402,360,178,192,54,113,52,48,350,312,133
"r/robinna01","Nate Robinson",866,418,449,31,229,212,154,174,35,63,72,100,157,112,85
"r/robinth01","Thomas Robinson",873,337,339,2,292,282,1,0,44,57,158,210,134,72,101
"r/rondora01","Rajon Rondo",998,379,350,-29,260,230,90,78,29,42,92,106,168,124,67
"r/rosede01","Derrick Rose",311,178,158,-20,117,84,47,48,14,26,44,48,73,36,32
"r/rosste01","Terrence Ross",2159,795,879,84,343,314,408,483,44,82,74,104,269,210,98
"r/rubiori01","Ricky Rubio",2638,800,781,-19,537,422,133,132,130,227,248,252,289,170,283
"r/rushbr01","Brandon Rush",418,91,79,-12,43,28,47,48,1,3,9,6,34,22,5
"s/sacrero01","Robert Sacre",1089,344,350,6,300,286,0,0,44,64,74,106,226,180,94
"s/salmojo01","John Salmons",1726,438,403,-35,250,174,163,189,25,40,29,30,221,144,52
"s/salmojo01","John Salmons",445,438,403,-35,250,174,163,189,25,40,29,30,221,144,52
"s/salmojo01","John Salmons",1281,438,403,-35,250,174,163,189,25,40,29,30,221,144,52
"s/sandela01","Larry Sanders",584,187,178,-9,161,152,1,0,25,26,98,116,63,36,55
"s/schrode01","Dennis Schroder",641,207,183,-24,146,124,42,30,19,29,56,66,90,58,43
"s/scolalu01","Luis Scola",1399,625,626,1,553,524,7,3,65,99,108,134,445,390,136
"s/scottmi01","Mike Scott",1482,685,767,82,428,478,200,186,57,103,164,238,264,240,132
"s/sefolth01","Thabo Sefolosha",1584,372,383,11,188,186,152,144,32,53,98,128,90,58,69
"s/serapke01","Kevin Seraphin",578,232,249,17,220,222,0,0,12,27,57,80,163,142,31
"s/sessira01","Ramon Sessions",2214,956,1019,63,645,590,124,105,187,324,314,354,331,236,404
"s/sessira01","Ramon Sessions",1305,956,1019,63,645,590,124,105,187,324,314,354,331,236,404
"s/sessira01","Ramon Sessions",909,956,1019,63,645,590,124,105,187,324,314,354,331,236,404
"s/shengto01","Tornike Shengelia",154,31,29,-2,22,26,6,0,3,3,14,18,8,8,8
"s/shengto01","Tornike Shengelia",137,31,29,-2,22,26,6,0,3,3,14,18,8,8,8
"s/shumpim01","Iman Shumpert",1962,517,495,-22,256,214,228,228,33,53,91,100,165,114,71
"s/shvedal01","Alexey Shved",664,276,250,-26,135,92,102,90,39,68,66,70,69,22,90
"s/simshe01","Henry Sims",875,330,350,20,273,260,1,0,56,90,95,114,178,146,121
"s/simshe01","Henry Sims",168,330,350,20,273,260,1,0,56,90,95,114,178,146,121
"s/simshe01","Henry Sims",707,330,350,20,273,260,1,0,56,90,95,114,178,146,121
"s/singlky01","Kyle Singler",2337,684,778,94,356,350,246,282,82,146,152,200,204,150,184
"s/singlch01","Chris Singleton",250,78,75,-3,48,36,19,21,11,18,13,18,35,18,25
"s/sivape01","Peyton Siva",224,64,54,-10,32,22,25,21,7,11,19,12,13,10,15
"s/sloando01","Donald Sloan",392,126,110,-16,75,68,42,30,9,12,28,32,47,36,20
"s/smithgr02","Greg Smith",100,30,38,8,28,36,0,0,2,2,16,26,12,10,5
"s/smithis01","Ish Smith",1006,297,261,-36,257,236,24,3,16,22,97,110,160,126,39
"s/smithjr01","J.R. Smith",2421,1015,1070,55,475,414,480,567,60,89,106,130,369,284,138
"s/smithja02","Jason Smith",830,305,301,-4,282,262,0,0,23,39,42,48,240,214,50
"s/smithjo03","Josh Smith",2730,1361,1264,-97,968,894,265,210,128,160,278,402,690,492,301
"s/snellto01","Tony Snell",1231,354,345,-9,158,144,178,171,18,30,42,50,116,94,41
"s/speigma01","Marreese Speights",982,500,508,8,411,374,31,24,58,110,138,172,273,202,134
"s/splitti01","Tiago Splitter",1271,423,483,60,343,362,3,0,77,121,187,236,156,126,173
"s/stephla01","Lance Stephenson",2752,953,1080,127,626,682,244,258,83,140,278,400,348,282,197
"s/stiemgr01","Greg Stiemsma",1007,136,159,23,121,140,1,0,14,19,67,100,54,40,32
"s/stoneju01","Julyan Stone",120,18,18,0,9,10,8,6,1,2,3,4,6,6,3
"s/stoudam01","Amar'e Stoudemire",1466,649,772,123,558,622,0,0,91,150,222,310,336,312,203
"s/stuckro01","Rodney Stuckey",1950,968,991,23,765,696,88,72,115,223,214,282,551,414,292
"s/sullija01","Jared Sullinger",2041,987,982,-5,691,656,208,168,88,158,260,312,431,344,203
"t/tayloje03","Jeffery Taylor",629,240,208,-32,151,128,67,54,22,26,84,100,67,28,47
"t/tayloty01","Tyshawn Taylor",270,106,89,-17,79,56,12,9,15,24,22,20,57,36,30
"t/teaguje01","Jeff Teague",2542,1206,1297,91,815,764,225,222,166,311,281,360,534,404,376
"t/teaguma01","Marquis Teague",443,135,107,-28,101,66,18,15,16,26,39,36,62,30,35
"t/teaguma01","Marquis Teague",242,135,107,-28,101,66,18,15,16,26,39,36,62,30,35
"t/teaguma01","Marquis Teague",201,135,107,-28,101,66,18,15,16,26,39,36,62,30,35
"t/teletmi01","Mirza Teletovic",1396,554,622,68,179,170,349,408,26,44,64,68,115,102,62
"t/templga01","Garrett Temple",638,159,138,-21,112,90,29,18,18,30,30,40,82,50,43
"t/terryja01","Jason Terry",570,157,158,1,49,32,103,117,5,9,3,6,46,26,15
"t/thabeha01","Hasheem Thabeet",192,25,27,2,23,26,0,0,2,1,8,12,15,14,5
"t/thomais02","Isaiah Thomas",2497,1264,1436,172,732,738,364,381,168,317,173,244,559,494,407
"t/thompho01","Hollis Thompson",1742,401,460,59,205,208,167,201,29,51,102,140,103,68,73
"t/thompja02","Jason Thompson",2007,563,586,23,496,502,0,0,67,84,144,210,352,292,145
"t/thompkl01","Klay Thompson",2868,1341,1483,142,724,672,535,669,82,142,148,206,576,466,185
"t/thomptr01","Tristan Thompson",2594,917,961,44,760,726,1,0,156,235,317,378,443,348,339
"t/thornma01","Marcus Thornton",1741,688,699,11,323,286,316,327,49,86,94,106,229,180,112
"t/thornma01","Marcus Thornton",1121,688,699,11,323,286,316,327,49,86,94,106,229,180,112
"t/thornma01","Marcus Thornton",620,688,699,11,323,286,316,327,49,86,94,106,229,180,112
"t/tinslja01","Jamaal Tinsley",110,20,9,-11,5,6,15,3,0,0,1,2,4,4,0
"t/tollian01","Anthony Tolliver",1298,322,393,71,60,54,247,306,15,33,23,34,37,20,41
"t/tuckepj01","P.J. Tucker",2490,706,760,54,424,382,191,222,91,156,200,220,224,162,201
"t/turiaro01","Ronny Turiaf",606,129,149,20,107,128,0,0,22,21,74,108,33,20,50
"t/turkohe01","Hedo Turkoglu",392,117,115,-2,59,40,50,66,8,9,13,12,46,28,18
"t/turneev01","Evan Turner",2457,1133,1117,-16,866,770,156,150,111,197,234,282,632,488,262
"t/turneev01","Evan Turner",1886,1133,1117,-16,866,770,156,150,111,197,234,282,632,488,262
"t/turneev01","Evan Turner",571,1133,1117,-16,866,770,156,150,111,197,234,282,632,488,262
"t/tylerje01","Jeremy Tyler",398,138,146,8,116,120,0,0,22,26,46,60,70,60,48
"u/udohek01","Ekpe Udoh",804,166,144,-22,143,114,0,0,23,30,46,46,97,68,47
"u/udrihbe01","Beno Udrih",643,193,200,7,136,118,42,57,15,25,28,30,108,88,30
"u/udrihbe01","Beno Udrih",588,193,200,7,136,118,42,57,15,25,28,30,108,88,30
"v/valanjo01","Jonas Valanciunas",2282,789,916,127,675,718,1,0,113,198,245,336,430,382,260
"v/varejan01","Anderson Varejao",1800,520,546,26,452,454,7,0,61,92,164,192,288,262,135
"v/varnaja01","Jarvis Varnado",339,84,99,15,60,72,0,0,24,27,26,38,34,34,52
"v/varnaja01","Jarvis Varnado",337,84,99,15,60,72,0,0,24,27,26,38,34,34,52
"v/vasqugr01","Greivis Vasquez",1779,704,750,46,369,336,289,327,46,87,52,64,317,272,108
"v/vasqugr01","Greivis Vasquez",465,704,750,46,369,336,289,327,46,87,52,64,317,272,108
"v/vasqugr01","Greivis Vasquez",1314,704,750,46,369,336,289,327,46,87,52,64,317,272,108
"v/veselja01","Jan Vesely",776,198,197,-1,173,178,0,0,25,19,96,128,77,50,56
"v/veselja01","Jan Vesely",470,198,197,-1,173,178,0,0,25,19,96,128,77,50,56
"v/veselja01","Jan Vesely",306,198,197,-1,173,178,0,0,25,19,96,128,77,50,56
"v/villach01","Charlie Villanueva",180,98,92,-6,36,42,56,42,6,8,13,22,23,20,14
"v/vucevni01","Nikola Vucevic",1812,759,811,52,696,706,0,0,63,105,251,328,445,378,137
"w/wadedw01","Dwyane Wade",1775,872,1027,155,729,812,32,27,111,188,245,352,484,460,258
"w/waitedi01","Dion Waiters",2072,1095,1109,14,743,676,249,276,103,157,253,284,490,392,235
"w/walkeke02","Kemba Walker",2614,1294,1274,-20,816,680,327,327,151,267,230,252,586,428,337
"w/walljo01","John Wall",2980,1503,1568,65,1029,942,308,324,166,302,329,446,700,496,394
"w/wallage01","Gerald Wallace",1416,277,298,21,166,194,64,57,47,47,114,156,52,38,101
"w/wareca01","Casper Ware",116,45,48,3,21,22,21,21,3,5,6,12,15,10,6
"w/watsocj01","C.J. Watson",1193,375,413,38,189,186,145,159,41,68,75,90,114,96,88
"w/watsoea01","Earl Watson",161,13,12,-1,4,2,7,6,2,4,0,0,4,2,4
"w/webstma02","Martell Webster",2157,637,757,120,215,216,372,438,50,103,77,106,138,110,125
"w/westda01","David West",2472,1054,1117,63,924,908,15,12,115,197,169,208,755,700,251
"w/westbru01","Russell Westbrook",1412,920,1002,82,577,556,214,204,129,242,241,302,336,254,293
"w/willide01","Deron Williams",2059,804,904,100,448,448,268,294,88,162,105,140,343,308,216
"w/willide02","Derrick Williams",1820,594,624,30,382,360,99,78,113,186,145,190,237,170,259
"w/willide02","Derrick Williams",162,594,624,30,382,360,99,78,113,186,145,190,237,170,259
"w/willide02","Derrick Williams",1658,594,624,30,382,360,99,78,113,186,145,190,237,170,259
"w/williel01","Elliot Williams",1157,389,401,12,212,206,125,111,52,84,125,156,87,50,119
"w/willilo02","Lou Williams",1445,570,620,50,262,236,231,237,77,147,63,86,199,150,179
"w/willima02","Marvin Williams",1674,557,603,46,292,294,234,252,31,57,97,142,195,152,73
"w/willima01","Mo Williams",1834,711,720,9,447,394,225,249,39,77,65,66,382,328,89
"w/willish03","Shawne Williams",751,202,202,0,63,62,129,126,10,14,28,28,35,34,20
"w/witheje01","Jeff Withey",684,161,190,29,127,138,1,0,33,52,73,90,54,48,73
"w/woltena01","Nate Wolters",1309,430,417,-13,327,304,62,54,41,59,129,158,198,146,90
"a/artesro01","Metta World Peace",388,148,139,-9,87,78,54,51,7,10,32,40,55,38,16
"w/wrighbr03","Brandan Wright",1077,378,525,147,331,448,0,0,47,77,185,296,146,152,106
"w/wrighch01","Chris Wright",126,41,48,7,34,42,1,0,6,6,26,34,8,8,15
"w/wrighdo01","Dorell Wright",984,324,343,19,95,84,202,207,27,52,32,42,63,42,69
"w/wroteto01","Tony Wroten",1765,953,938,-15,620,610,188,120,145,208,395,472,225,138,326
"y/youngni01","Nick Young",1810,1002,1139,137,539,504,350,405,113,230,121,164,418,340,285
"y/youngth01","Thaddeus Young",2718,1383,1417,34,991,984,292,270,100,163,433,574,558,410,229
"z/zelleco01","Cody Zeller",1416,495,490,-5,403,344,1,0,91,146,182,214,221,130,200
"z/zellety01","Tyler Zeller",1049,344,399,55,289,312,1,0,54,87,144,190,145,122,121
