"player_id","player_nm","mp","poss","pts","diff","poss2","pts2","poss3","pts3","possft","ptsft","poss2_rim","pts2_rim","poss2_other","pts2_other","tot_fta"
"a/acyqu01","Quincy Acy",1287,374,398,24,271,268,60,54,43,76,98,132,173,136,97
"a/adamsjo01","Jordan Adams",248,96,94,-2,61,50,25,30,10,14,25,28,36,22,23
"a/adamsst01","Steven Adams",1771,490,537,47,397,434,2,0,91,103,241,310,156,124,205
"a/adrieje01","Jeff Adrien",215,61,60,-1,44,38,0,0,17,22,23,24,21,14,38
"a/afflaar01","Arron Afflalo",2502,964,1022,58,551,514,333,354,80,154,110,126,441,388,198
"a/afflaar01","Arron Afflalo",1750,964,1022,58,551,514,333,354,80,154,110,126,441,388,198
"a/afflaar01","Arron Afflalo",752,964,1022,58,551,514,333,354,80,154,110,126,441,388,198
"a/ajincal01","Alexis Ajinca",957,373,443,70,328,362,0,0,45,81,116,140,212,222,99
"a/aldemfu01","Furkan Aldemir",540,91,93,2,73,80,5,0,13,13,49,68,24,12,27
"a/aldrico01","Cole Aldrich",976,329,338,9,301,288,0,0,28,50,108,146,193,142,64
"a/aldrila01","LaMarcus Aldridge",2512,1574,1654,80,1310,1244,105,111,159,299,273,382,1037,862,362
"a/allenla01","Lavoy Allen",1070,322,317,-5,300,284,0,0,22,33,95,134,205,150,48
"a/allento01","Tony Allen",1648,511,539,28,426,430,29,30,56,79,314,354,112,76,126
"a/aminual01","Al-Farouq Aminu",1366,410,412,2,233,226,124,102,53,84,147,182,86,44,118
"a/amundlo01","Lou Amundson",937,294,259,-35,254,218,1,0,39,41,128,122,126,96,87
"a/amundlo01","Lou Amundson",858,294,259,-35,254,218,1,0,39,41,128,122,126,96,87
"a/anderch01","Chris Andersen",1132,261,320,59,194,232,13,12,54,76,146,196,48,36,114
"a/anderal01","Alan Anderson",1744,482,543,61,229,242,210,219,43,82,101,138,128,104,101
"a/anderky01","Kyle Anderson",358,94,74,-20,78,56,11,9,5,9,23,26,55,30,14
"a/anderry01","Ryan Anderson",1675,792,830,38,370,338,359,366,63,126,156,174,214,164,151
"a/antetgi01","Giannis Antetokounmpo",2541,935,1030,95,736,752,44,21,155,257,395,510,341,242,347
"a/anthoca01","Carmelo Anthony",1428,904,955,51,627,594,179,183,98,178,178,208,449,386,237
"a/anthojo01","Joel Anthony",406,71,87,16,62,72,0,0,9,15,32,52,30,20,22
"a/anticpe01","Pero Antic",1037,349,356,7,123,112,173,156,53,88,71,78,52,34,123
"a/arizatr01","Trevor Ariza",2930,973,1047,74,354,344,555,582,64,121,205,252,149,92,143
"a/arthuda01","Darrell Arthur",988,413,382,-31,274,258,110,78,29,46,53,66,221,192,59
"a/asikom01","Omer Asik",1982,515,557,42,412,426,1,0,102,131,369,408,43,18,225
"a/augusdj01","D.J. Augustin",1964,737,770,33,401,350,246,249,90,171,162,194,239,156,205
"a/augusdj01","D.J. Augustin",1287,737,770,33,401,350,246,249,90,171,162,194,239,156,205
"a/augusdj01","D.J. Augustin",677,737,770,33,401,350,246,249,90,171,162,194,239,156,205
"p/pendeje02","Jeff Ayres",383,110,137,27,95,110,0,0,15,27,62,88,33,22,36
"b/babbilu01","Luke Babbitt",830,201,256,55,77,66,115,177,9,13,18,20,59,46,19
"b/barbole01","Leandro Barbosa",982,420,466,46,274,280,112,129,34,57,143,186,131,94,74
"b/bareajo01","J.J. Barea",1362,580,580,0,369,342,167,162,44,76,138,152,231,190,94
"b/bargnan01","Andrea Bargnani",785,409,428,19,320,298,41,45,48,85,56,64,264,234,107
"b/barneha02","Harrison Barnes",2318,724,827,103,441,458,215,261,68,108,203,278,238,180,150
"b/barnema02","Matt Barnes",2271,668,764,96,248,282,376,408,44,74,158,216,90,66,95
"b/barroea01","Earl Barron",143,45,32,-13,35,20,4,6,6,6,11,2,24,18,12
"b/bartowi01","Will Barton",983,395,397,2,268,254,85,69,42,74,122,150,146,104,94
"b/bartowi01","Will Barton",300,395,397,2,268,254,85,69,42,74,122,150,146,104,94
"b/bartowi01","Will Barton",683,395,397,2,268,254,85,69,42,74,122,150,146,104,94
"b/bassbr01","Brandon Bass",1929,777,865,88,651,670,32,27,94,168,252,342,399,328,214
"b/batumni01","Nicolas Batum",2380,643,664,21,291,280,308,300,44,84,108,150,183,130,98
"b/bayleje01","Jerryd Bayless",1717,574,591,17,396,366,120,111,58,114,125,150,271,216,137
"b/baynear01","Aron Baynes",1122,373,461,88,323,368,4,3,46,90,181,230,142,138,104
"b/bazemke01","Kent Bazemore",1324,376,390,14,199,186,132,144,45,60,109,132,90,54,100
"b/bealbr01","Bradley Beal",2107,919,947,28,593,516,259,318,67,113,176,236,417,280,166
"b/beaslmi01","Michael Beasley",505,223,212,-11,178,168,34,24,11,20,44,54,134,114,26
"b/belinma01","Marco Belinelli",1388,513,562,49,240,226,230,258,43,78,61,74,179,152,99
"b/bennean01","Anthony Bennett",894,326,298,-28,274,236,22,21,30,41,93,126,181,110,64
"b/beverpa01","Patrick Beverley",1727,561,568,7,209,178,323,345,29,45,95,96,114,82,60
"b/biyombi01","Bismack Biyombo",1243,268,304,36,186,202,0,0,82,102,137,180,49,22,175
"b/blackta01","Tarik Black",1196,328,379,51,272,314,1,0,55,65,189,246,83,68,118
"b/blackta01","Tarik Black",393,328,379,51,272,314,1,0,55,65,189,246,83,68,118
"b/blackta01","Tarik Black",803,328,379,51,272,314,1,0,55,65,189,246,83,68,118
"b/blairde01","DeJuan Blair",180,60,56,-4,57,52,0,0,3,4,22,24,35,28,6
"b/blakest01","Steve Blake",1529,344,348,4,108,90,219,231,17,27,22,26,86,64,41
"b/bledser01","Eric Bledsoe",2800,1228,1358,130,775,760,272,264,181,334,364,466,411,294,441
"b/bogdabo02","Bojan Bogdanovic",1854,624,698,74,320,340,256,273,48,85,154,218,166,122,106
"b/bogutan01","Andrew Bogut",1583,371,422,51,355,400,0,0,16,22,210,270,145,130,42
"b/bonnema01","Matt Bonner",935,246,263,17,104,96,126,138,16,29,11,16,93,80,37
"b/booketr01","Trevor Booker",1564,533,567,34,380,394,84,87,69,86,174,252,206,142,148
"b/boozeca01","Carlos Boozer",1692,808,836,28,743,742,0,0,65,94,279,376,464,366,150
"b/boshch01","Chris Bosh",1556,844,916,72,577,560,168,189,99,167,124,138,453,422,232
"b/bradlav01","Avery Bradley",2428,1053,1066,13,660,620,352,372,41,74,170,208,490,412,100
"b/brandel01","Elton Brand",486,106,96,-10,94,84,1,0,11,12,16,22,78,62,23
"b/breweco01","Corey Brewer",2087,908,917,9,571,560,235,189,102,168,308,394,263,166,226
"b/breweco01","Corey Brewer",680,908,917,9,571,560,235,189,102,168,308,394,263,166,226
"b/breweco01","Corey Brewer",1407,908,917,9,571,560,235,189,102,168,308,394,263,166,226
"b/brookaa01","Aaron Brooks",1885,890,944,54,504,446,313,363,73,135,218,228,286,218,174
"b/brownja01","Jabari Brown",568,208,227,19,108,94,62,69,38,64,47,52,61,42,85
"b/brownlo01","Lorenzo Brown",549,131,122,-9,94,92,28,18,9,12,45,50,49,42,19
"b/brownma02","Markel Brown",781,237,216,-21,146,118,64,51,27,47,60,66,86,52,57
"b/bryanko01","Kobe Bryant",1207,813,770,-43,529,424,184,162,100,184,97,110,432,314,241
"b/budinch01","Chase Budinger",1286,422,453,31,247,234,143,156,32,63,102,130,145,104,81
"b/bullore01","Reggie Bullock",338,74,69,-5,24,18,46,45,4,6,10,14,14,4,9
"b/bullore01","Reggie Bullock",263,74,69,-5,24,18,46,45,4,6,10,14,14,4,9
"b/burketr01","Trey Burke",2288,1069,969,-100,615,492,390,372,64,105,150,148,465,344,145
"b/burksal01","Alec Burks",899,356,371,15,232,190,68,78,56,103,87,86,145,104,129
"b/butleca01","Caron Butler",1623,420,458,38,177,156,219,249,24,53,25,26,152,130,61
"b/butleji01","Jimmy Butler",2513,1123,1298,175,719,696,193,219,211,383,306,382,413,314,463
"b/butlera01","Rasual Butler",1505,545,578,33,282,254,235,273,28,51,73,98,209,156,67
"b/buyckdw01","Dwight Buycks",123,44,52,8,29,22,11,21,4,9,12,10,17,12,10
"c/calatni01","Nick Calathes",838,266,243,-23,204,186,43,33,19,24,89,110,115,76,45
"c/caldejo01","Jose Calderon",1270,368,380,12,212,176,142,177,14,27,36,44,176,132,32
"c/caldwke01","Kentavious Caldwell-Pope",2587,1040,1042,2,528,474,444,459,68,109,220,264,308,210,158
"c/canaais01","Isaiah Canaan",938,402,431,29,132,110,246,273,24,48,65,60,67,50,60
"c/canaais01","Isaiah Canaan",369,402,431,29,132,110,246,273,24,48,65,60,67,50,60
"c/canaais01","Isaiah Canaan",569,402,431,29,132,110,246,273,24,48,65,60,67,50,60
"c/carrode01","DeMarre Carroll",2189,732,883,151,349,396,304,360,79,127,201,264,148,132,181
"c/cartevi01","Vince Carter",1091,433,382,-51,174,132,232,207,27,43,53,50,121,82,57
"c/cartemi01","Michael Carter-Williams",2149,1051,964,-87,766,656,153,108,132,200,306,360,460,296,291
"c/cartemi01","Michael Carter-Williams",1391,1051,964,-87,766,656,153,108,132,200,306,360,460,296,291
"c/cartemi01","Michael Carter-Williams",758,1051,964,-87,766,656,153,108,132,200,306,360,460,296,291
"c/casspom01","Omri Casspi",1416,514,592,78,340,348,87,105,87,139,162,234,178,114,191
"c/chalmma01","Mario Chalmers",2368,777,803,26,414,386,248,219,115,198,202,214,212,172,266
"c/chandty01","Tyson Chandler",2286,555,771,216,440,586,0,0,115,185,354,528,86,58,257
"c/chandwi01","Wilson Chandler",2471,1034,1085,51,569,558,406,417,59,110,260,334,309,224,142
"c/clarkia01","Ian Clark",192,59,57,-2,25,18,30,30,4,9,9,14,16,4,9
"c/clarkia01","Ian Clark",161,59,57,-2,25,18,30,30,4,9,9,14,16,4,9
"c/clarkjo01","Jordan Clarkson",1476,666,702,36,474,458,121,114,71,130,169,224,305,234,158
"c/coleno01","Norris Cole",1831,596,571,-25,382,350,176,165,38,56,136,146,246,204,81
"c/coleno01","Norris Cole",1148,596,571,-25,382,350,176,165,38,56,136,146,246,204,81
"c/coleno01","Norris Cole",683,596,571,-25,382,350,176,165,38,56,136,146,246,204,81
"c/collida01","Darren Collison",1565,631,716,85,389,400,161,180,81,136,136,186,253,214,184
"c/collini01","Nick Collison",1101,281,273,-8,193,180,60,48,28,45,96,124,97,56,65
"c/conlemi01","Mike Conley",2225,985,1091,106,605,572,277,321,103,198,243,284,362,288,249
"c/copelch01","Chris Copeland",828,327,308,-19,143,120,167,156,17,32,67,74,76,46,45
"c/cottobr01","Bryce Cotton",159,77,80,3,49,44,20,21,8,15,6,8,43,36,18
"c/couside01","DeMarcus Cousins",2013,1305,1417,112,1058,992,8,6,239,419,456,572,602,420,541
"c/covinro01","Robert Covington",1956,847,942,95,310,264,446,501,91,177,156,184,154,80,217
"c/crabbal01","Allen Crabbe",683,160,168,8,68,66,85,90,7,12,30,52,38,14,16
"c/crawfja01","Jamal Crawford",1703,941,999,58,475,426,364,357,102,216,66,74,409,352,252
"c/crowdja01","Jae Crowder",1647,608,628,20,339,336,208,183,61,109,153,188,186,148,141
"c/crowdja01","Jae Crowder",265,608,628,20,339,336,208,183,61,109,153,188,186,148,141
"c/crowdja01","Jae Crowder",1382,608,628,20,339,336,208,183,61,109,153,188,186,148,141
"c/cunnida01","Dante Cunningham",1652,361,340,-21,329,308,10,3,22,29,83,110,246,198,47
"c/curryst01","Stephen Curry",2613,1476,1877,401,695,734,646,858,135,285,249,342,446,392,339
"d/dalemsa01","Samuel Dalembert",544,139,128,-11,130,114,0,0,9,14,49,60,81,54,20
"d/danietr01","Troy Daniels",397,171,176,5,47,36,118,129,6,11,10,8,37,28,13
"d/danietr01","Troy Daniels",108,171,176,5,47,36,118,129,6,11,10,8,37,28,13
"d/danietr01","Troy Daniels",154,171,176,5,47,36,118,129,6,11,10,8,37,28,13
"d/danietr01","Troy Daniels",135,171,176,5,47,36,118,129,6,11,10,8,37,28,13
"d/datomlu01","Luigi Datome",209,89,104,15,49,50,40,54,0,0,12,16,37,34,1
"d/datomlu01","Luigi Datome",192,89,104,15,49,50,40,54,0,0,12,16,37,34,1
"d/daviebr01","Brandon Davies",423,153,142,-11,103,94,34,24,16,24,46,44,57,50,37
"d/daviebr01","Brandon Davies",379,153,142,-11,103,94,34,24,16,24,46,44,57,50,37
"d/davisan02","Anthony Davis",2455,1394,1640,246,1187,1282,12,3,195,355,422,622,765,660,461
"d/davised01","Ed Davis",1840,551,656,105,469,564,0,0,82,92,338,464,131,100,189
"d/davisgl01","Glen Davis",904,299,294,-5,251,234,4,0,44,60,125,154,126,80,95
"d/dayeau01","Austin Daye",344,143,129,-14,70,52,70,72,3,5,13,14,57,38,6
"d/dayeau01","Austin Daye",268,143,129,-14,70,52,70,72,3,5,13,14,57,38,6
"d/dedmode01","Dewayne Dedmon",845,191,216,25,161,182,1,0,29,34,110,148,51,34,64
"d/dellama01","Matthew Dellavedova",1380,326,319,-7,140,86,167,204,19,29,18,14,122,72,38
"d/denglu01","Luol Deng",2421,907,1007,100,567,582,221,234,119,191,243,314,324,268,251
"d/derozde01","DeMar DeRozan",2100,1178,1184,6,902,768,88,75,188,341,191,246,711,522,434
"d/diawbo01","Boris Diaw",1984,674,708,34,463,474,170,162,41,72,184,220,279,254,93
"d/dienggo01","Gorgui Dieng",2193,624,710,86,506,516,6,3,112,191,208,264,298,252,244
"d/dinwisp01","Spencer Dinwiddie",455,184,145,-39,104,78,65,36,15,31,37,34,67,44,34
"d/dorsejo01","Joey Dorsey",854,185,184,-1,144,160,1,0,40,24,112,138,32,22,83
"d/douglto01","Toney Douglas",177,57,51,-6,33,28,18,15,6,8,9,18,24,10,13
"d/douglch01","Chris Douglas-Roberts",103,25,19,-6,14,8,7,3,4,8,9,8,5,0,8
"d/dragigo01","Goran Dragic",2640,1102,1270,168,743,824,259,270,100,176,416,582,327,242,234
"d/dragigo01","Goran Dragic",1735,1102,1270,168,743,824,259,270,100,176,416,582,327,242,234
"d/dragigo01","Goran Dragic",905,1102,1270,168,743,824,259,270,100,176,416,582,327,242,234
"d/drewla02","Larry Drew",219,59,46,-13,32,32,26,12,1,2,5,10,27,22,3
"d/drumman01","Andre Drummond",2502,1127,1130,3,960,988,2,0,165,142,660,792,300,196,365
"d/dudleja01","Jared Dudley",1717,454,518,64,231,248,192,222,31,48,72,96,159,152,67
"d/duncati01","Tim Duncan",2227,958,1070,112,811,834,7,6,140,230,291,414,520,420,311
"d/dunlemi02","Mike Dunleavy",1838,516,591,75,218,204,263,321,35,66,83,94,135,110,87
"d/duranke01","Kevin Durant",913,537,674,137,308,348,159,192,70,134,96,154,212,194,171
"e/earlycl01","Cleanthony Early",647,235,210,-25,130,108,84,66,21,36,60,68,70,40,48
"e/ellinwa01","Wayne Ellington",1675,645,647,2,374,328,243,270,28,49,98,122,276,206,65
"e/ellismo01","Monta Ellis",2699,1487,1506,19,1070,1042,284,243,133,221,339,422,731,620,303
"e/ennisja01","James Ennis",1051,289,312,23,152,140,95,93,42,79,92,108,60,32,94
"e/ennisty01","Tyler Ennis",411,147,121,-26,101,80,43,36,3,5,44,40,57,40,7
"e/ennisty01","Tyler Ennis",353,147,121,-26,101,80,43,36,3,5,44,40,57,40,7
"e/evansje01","Jeremy Evans",266,70,90,20,53,60,5,6,12,24,33,52,20,8,29
"e/evansre01","Reggie Evans",764,184,176,-8,135,116,2,0,47,60,76,90,59,26,97
"e/evansty01","Tyreke Evans",2690,1294,1313,19,938,904,227,207,129,202,626,698,312,206,291
"e/exumda01","Dante Exum",1817,430,393,-37,152,124,264,249,14,20,52,76,100,48,32
"e/ezelife01","Festus Ezeli",504,176,201,25,139,152,0,0,37,49,72,94,67,58,78
"f/farieke01","Kenneth Faried",2086,861,946,85,728,744,8,3,125,199,425,536,303,208,288
"f/farmajo01","Jordan Farmar",529,163,167,4,61,52,97,105,5,10,17,20,44,32,11
"f/favorde01","Derrick Favors",2280,1067,1187,120,912,962,6,3,149,222,406,600,506,362,332
"f/feltora01","Raymond Felton",281,113,108,-5,72,66,34,30,7,12,25,30,47,36,15
"f/fieldla01","Landry Fields",216,44,46,2,39,38,2,3,3,5,19,26,20,12,6
"f/fournev01","Evan Fournier",1661,640,697,57,350,336,225,255,65,106,195,248,155,88,147
"f/foyera01","Randy Foye",1087,425,431,6,139,108,263,282,23,41,40,50,99,58,55
"f/fraziti01","Tim Frazier",239,70,57,-13,44,32,17,15,9,10,15,18,29,14,21
"f/fraziti01","Tim Frazier",171,70,57,-13,44,32,17,15,9,10,15,18,29,14,21
"f/fredeji01","Jimmer Fredette",509,183,175,-8,118,108,48,27,17,40,36,38,82,70,45
"f/freeljo01","Joel Freeland",617,161,169,8,151,148,0,0,10,21,49,60,102,88,25
"f/fryech01","Channing Frye",1870,500,545,45,141,110,346,408,13,27,25,18,116,92,35
"g/gallida01","Danilo Gallinari",1426,651,726,75,267,242,301,321,83,163,97,120,170,122,191
"g/gallola01","Langston Galloway",1457,544,531,-13,335,284,176,186,33,61,110,112,225,172,78
"g/garcifr01","Francisco Garcia",200,64,45,-19,18,14,45,30,1,1,8,12,10,2,4
"g/garneke01","Kevin Garnett",952,326,323,-3,299,284,7,3,20,36,45,48,254,236,45
"g/garneke01","Kevin Garnett",854,326,323,-3,299,284,7,3,20,36,45,48,254,236,45
"g/gasolma01","Marc Gasol",2687,1266,1413,147,1055,1054,17,9,194,350,258,360,797,694,440
"g/gasolpa01","Pau Gasol",2681,1318,1446,128,1127,1116,26,36,165,294,368,448,759,668,366
"g/gayru01","Rudy Gay",2408,1284,1408,124,896,858,220,237,168,313,225,280,671,578,393
"g/geeal01","Alonzo Gee",662,221,241,20,151,148,35,39,35,54,106,132,45,16,77
"g/geeal01","Alonzo Gee",511,221,241,20,151,148,35,39,35,54,106,132,45,16,77
"g/geeal01","Alonzo Gee",151,221,241,20,151,148,35,39,35,54,106,132,45,16,77
"g/gibsota01","Taj Gibson",1692,592,642,50,507,510,0,0,85,132,281,348,226,162,184
"g/ginobma01","Manu Ginobili",1587,681,737,56,331,324,258,267,92,146,165,196,166,128,204
"g/goberru01","Rudy Gobert",2158,552,686,134,425,516,2,0,125,170,336,476,89,40,273
"g/goodedr01","Drew Gooden",864,298,277,-21,217,174,60,69,21,34,61,56,156,118,44
"g/goodwar01","Archie Goodwin",535,237,230,-7,160,134,41,36,36,60,106,112,54,22,83
"g/gordoaa01","Aaron Gordon",797,234,243,9,160,160,48,39,26,44,96,122,64,38,61
"g/gordobe01","Ben Gordon",790,325,347,22,198,188,97,105,30,54,26,26,172,162,67
"g/gordoer01","Eric Gordon",2018,752,815,63,378,288,315,423,59,104,139,128,239,160,133
"g/gortama01","Marcin Gortat",2453,854,1001,147,772,878,3,0,79,123,368,544,404,334,175
"g/grangda01","Danny Granger",613,178,188,10,78,70,84,90,16,28,25,28,53,42,37
"g/grantje01","Jerami Grant",1377,443,411,-32,196,150,156,147,91,114,113,122,83,28,193
"g/greenda02","Danny Green",2312,783,926,143,281,262,457,573,45,91,125,146,156,116,127
"g/greendr01","Draymond Green",2490,853,921,68,436,456,329,333,88,132,256,348,180,108,200
"g/greener01","Erick Green",410,167,146,-21,115,94,47,42,5,10,12,16,103,78,12
"g/greenge01","Gerald Green",1446,824,881,57,391,374,387,411,46,96,103,136,288,238,120
"g/greenja01","JaMychal Green",164,52,62,10,41,54,6,0,5,8,25,38,16,16,10
"g/greenja01","JaMychal Green",139,52,62,10,41,54,6,0,5,8,25,38,16,16,10
"g/greenje02","Jeff Green",2454,1094,1164,70,675,638,292,291,127,235,257,320,418,318,287
"g/greenje02","Jeff Green",1093,1094,1164,70,675,638,292,291,127,235,257,320,418,318,287
"g/greenje02","Jeff Green",1361,1094,1164,70,675,638,292,291,127,235,257,320,418,318,287
"g/greenwi01","Willie Green",951,321,306,-15,185,152,121,126,15,28,60,72,125,80,34
"g/griffbl01","Blake Griffin",2356,1333,1469,136,1119,1128,25,30,189,311,380,538,739,590,427
"g/gutiejo01","Jorge Gutierrez",175,46,53,7,38,44,3,0,5,9,16,22,22,22,13
"g/gutiejo01","Jorge Gutierrez",131,46,53,7,38,44,3,0,5,9,16,22,22,22,13
"h/hairspj02","P.J. Hairston",687,284,254,-30,106,76,163,147,15,31,46,32,60,44,36
"h/hamiljo02","Jordan Hamilton",122,35,38,3,14,8,21,30,0,0,3,4,11,4,0
"h/hamilju01","Justin Hamilton",712,199,219,20,147,150,31,30,21,39,78,96,69,54,47
"h/hamilju01","Justin Hamilton",289,199,219,20,147,150,31,30,21,39,78,96,69,54,47
"h/hamilju01","Justin Hamilton",423,199,219,20,147,150,31,30,21,39,78,96,69,54,47
"h/hansbty01","Tyler Hansbrough",1058,229,270,41,158,170,7,3,64,97,107,122,51,48,139
"h/hardati02","Tim Hardaway",1681,781,803,22,363,316,354,363,64,124,137,166,226,150,156
"h/hardeja01","James Harden",2981,1826,2185,359,915,878,555,624,356,683,457,562,458,316,824
"h/harklma01","Maurice Harkless",674,176,158,-18,102,106,56,30,18,22,80,94,22,12,41
"h/harride01","Devin Harris",1685,598,664,66,258,248,266,285,74,131,126,156,132,92,162
"h/harriga01","Gary Harris",719,238,187,-51,114,90,103,63,21,34,50,48,64,42,47
"h/harrijo01","Joe Harris",493,126,135,9,36,34,84,93,6,8,15,16,21,18,15
"h/harrito02","Tobias Harris",2369,1052,1160,108,710,710,239,261,103,189,281,384,429,326,245
"h/hasleud01","Udonis Haslem",995,268,261,-7,229,210,10,6,29,45,106,120,123,90,64
"h/hawessp01","Spencer Hawes",1274,446,425,-21,239,216,175,165,32,44,82,98,157,118,68
"h/hayesch01","Chuck Hayes",255,51,50,-1,46,44,0,0,5,6,26,24,20,20,11
"h/haywago01","Gordon Hayward",2618,1293,1455,162,757,728,330,360,206,367,227,288,530,440,462
"h/haywobr01","Brendan Haywood",119,35,35,0,30,28,0,0,5,7,5,8,25,20,13
"h/hendege02","Gerald Henderson",2315,945,968,23,711,650,136,135,98,183,176,224,535,426,217
"h/hensojo01","John Henson",1228,408,470,62,346,392,0,0,62,78,222,286,124,106,137
"h/hibbero01","Roy Hibbert",1926,807,802,-5,708,634,2,0,97,168,156,174,552,460,204
"h/hicksjj01","J.J. Hickson",1411,551,552,1,457,436,2,0,92,116,256,312,201,124,201
"h/hilarne01","Nene Hilario",1693,689,737,48,596,612,5,3,88,122,254,354,342,258,202
"h/hillge01","George Hill",1267,599,690,91,342,372,193,207,64,111,121,170,221,202,143
"h/hilljo01","Jordan Hill",1874,854,841,-13,766,708,11,9,77,124,193,266,573,442,168
"h/hillso01","Solomon Hill",2381,725,729,4,426,366,208,204,91,159,223,224,203,142,193
"h/hinriki01","Kirk Hinrich",1610,404,377,-27,213,168,168,174,23,35,42,48,171,120,50
"h/holidjr01","Jrue Holiday",1303,565,587,22,399,374,134,153,32,60,141,158,258,216,76
"h/holidju01","Justin Holiday",657,255,253,-2,126,112,109,105,20,36,47,52,79,60,45
"h/holliry01","Ryan Hollins",441,108,137,29,82,106,0,0,26,31,47,76,35,30,54
"h/hoodro01","Rodney Hood",1064,408,430,22,204,186,170,186,34,58,48,64,156,122,80
"h/horfoal01","Al Horford",2318,1027,1156,129,929,1016,36,33,62,107,278,416,651,600,141
"h/howardw01","Dwight Howard",1223,543,646,103,421,500,2,3,120,143,264,382,157,118,271
"h/hummero01","Robbie Hummel",742,185,198,13,121,126,51,48,13,24,30,54,91,72,29
"h/humphkr01","Kris Humphries",1345,498,509,11,439,422,7,0,52,87,145,178,294,244,117
"i/ibakase01","Serge Ibaka",2116,835,916,81,581,594,205,231,49,91,159,216,422,378,110
"i/iguodan01","Andre Iguodala",2069,545,604,59,284,314,212,222,49,68,144,216,140,98,114
"i/ilyaser01","Ersan Ilyasova",1319,607,669,62,367,378,190,222,50,69,192,228,175,150,107
"i/inglejo01","Joe Ingles",1673,371,396,25,152,150,202,216,17,30,42,62,110,88,40
"i/irvinky01","Kyrie Irving",2730,1383,1606,223,857,842,378,471,148,293,337,412,520,430,365
"j/jackja01","Jarrett Jack",2241,917,947,30,671,640,146,117,100,190,107,130,564,510,227
"j/jacksre01","Reggie Jackson",2268,1088,1111,23,755,720,241,216,92,175,270,332,485,388,218
"j/jacksre01","Reggie Jackson",1398,1088,1111,23,755,720,241,216,92,175,270,332,485,388,218
"j/jacksre01","Reggie Jackson",870,1088,1111,23,755,720,241,216,92,175,270,332,485,388,218
"j/jamesbe01","Bernard James",158,38,44,6,27,24,0,0,11,20,22,24,5,0,23
"j/jamesle01","LeBron James",2493,1504,1735,231,940,1008,340,360,224,367,427,616,513,392,528
"j/jeffeal01","Al Jefferson",1992,1082,1080,-2,1004,966,5,6,73,108,284,362,720,604,165
"j/jeffeco01","Cory Jefferson",531,192,183,-9,152,146,15,6,25,31,54,66,98,80,54
"j/jefferi01","Richard Jefferson",1244,377,432,55,169,156,155,198,53,78,82,104,87,52,114
"j/jenkijo01","John Jenkins",297,107,134,27,47,56,52,63,8,15,12,22,35,34,19
"j/jennibr01","Brandon Jennings",1173,602,628,26,332,284,211,228,59,116,152,158,180,126,143
"j/jerebjo01","Jonas Jerebko",1230,408,446,38,239,230,140,162,29,54,112,146,127,84,66
"j/jerebjo01","Jonas Jerebko",703,408,446,38,239,230,140,162,29,54,112,146,127,84,66
"j/jerebjo01","Jonas Jerebko",527,408,446,38,239,230,140,162,29,54,112,146,127,84,66
"j/johnsam01","Amir Johnson",1979,578,694,116,473,558,46,57,59,79,254,356,219,202,129
"j/johnsch04","Chris Johnson",526,160,166,6,59,68,95,84,6,14,38,50,21,18,16
"j/johnsch04","Chris Johnson",187,160,166,6,59,68,95,84,6,14,38,50,21,18,16
"j/johnsch04","Chris Johnson",211,160,166,6,59,68,95,84,6,14,38,50,21,18,16
"j/johnsch04","Chris Johnson",128,160,166,6,59,68,95,84,6,14,38,50,21,18,16
"j/johnsja01","James Johnson",1370,447,554,107,353,454,51,33,43,67,215,328,138,126,102
"j/johnsjo02","Joe Johnson",2791,1104,1150,46,688,650,337,363,79,137,100,114,588,536,176
"j/johnsni01","Nick Johnson",262,87,74,-13,54,42,21,15,12,17,32,30,22,12,25
"j/johnsty01","Tyler Johnson",603,190,190,0,119,104,48,54,23,32,49,58,70,46,47
"j/johnswe01","Wesley Johnson",2245,739,750,11,432,390,259,273,48,87,108,152,324,238,112
"j/jonesda02","Dahntay Jones",123,26,21,-5,17,12,4,0,5,9,6,10,11,2,11
"j/jonesja02","James Jones",669,218,249,31,26,22,175,189,17,38,3,4,23,18,46
"j/jonespe01","Perry Jones",631,200,187,-13,124,118,61,45,15,24,37,50,87,68,37
"j/joneste01","Terrence Jones",889,342,386,44,262,290,37,39,43,57,151,210,111,80,94
"j/jordade01","DeAndre Jordan",2820,749,946,197,530,756,4,3,215,187,491,726,39,30,471
"j/jordaje01","Jerome Jordan",383,113,138,25,94,100,0,0,19,38,75,88,19,12,44
"j/josepco01","Cory Joseph",1444,472,535,63,367,382,44,48,61,105,161,194,206,188,143
"k/kamanch01","Chris Kaman",1398,592,638,46,549,566,0,0,43,72,201,268,348,298,102
"k/kanteen01","Enes Kanter",2135,1029,1163,134,883,932,45,48,101,183,467,622,416,310,234
"k/kanteen01","Enes Kanter",1326,1029,1163,134,883,932,45,48,101,183,467,622,416,310,234
"k/kanteen01","Enes Kanter",809,1029,1163,134,883,932,45,48,101,183,467,622,416,310,234
"k/karasse01","Sergey Karasev",555,151,151,0,80,76,54,48,17,27,38,42,42,34,38
"k/kellyry01","Ryan Kelly",1233,349,328,-21,175,118,134,135,40,75,45,58,130,60,95
"k/kiddgmi01","Michael Kidd-Gilchrist",1587,578,598,20,482,448,0,0,96,150,230,266,252,182,214
"k/knighbr03","Brandon Knight",2035,985,1061,76,567,500,321,375,97,186,242,280,325,220,223
"k/knighbr03","Brandon Knight",1688,985,1061,76,567,500,321,375,97,186,242,280,325,220,223
"k/knighbr03","Brandon Knight",347,985,1061,76,567,500,321,375,97,186,242,280,325,220,223
"k/korveky01","Kyle Korver",2418,642,898,256,151,142,449,663,42,93,28,38,123,104,118
"k/koufoko01","Kosta Koufos",1348,398,419,21,358,364,0,0,40,55,160,198,198,166,85
"l/lambje01","Jeremy Lamb",633,273,294,21,139,132,111,114,23,48,40,60,99,72,55
"l/landrca01","Carl Landry",1192,439,503,64,369,380,0,0,70,123,130,182,239,198,150
"l/larkish01","Shane Larkin",1865,467,470,3,316,304,116,105,35,61,123,148,193,156,78
"l/lauvejo01","Joffrey Lauvergne",268,100,93,-7,73,66,16,9,11,18,45,60,28,6,28
"l/lavinza01","Zach LaVine",1902,753,774,21,510,458,167,171,76,145,188,238,322,220,177
"l/lawsoty01","Ty Lawson",2665,1092,1142,50,721,668,205,210,166,264,232,298,489,370,363
"l/ledori01","Ricky Ledo",244,106,90,-16,69,44,27,30,10,16,30,28,39,16,22
"l/ledori01","Ricky Ledo",233,106,90,-16,69,44,27,30,10,16,30,28,39,16,22
"l/leeco01","Courtney Lee",2354,690,748,58,419,396,225,270,46,82,100,130,319,266,129
"l/leeda02","David Lee",904,361,388,27,311,320,2,0,48,68,151,208,160,112,104
"l/lenal01","Alex Len",1518,396,432,36,350,356,3,3,43,73,192,260,158,96,104
"l/leonaka01","Kawhi Leonard",2033,934,1055,121,630,654,192,201,112,200,174,252,456,402,252
"l/leoname01","Meyers Leonard",847,257,326,69,133,156,112,141,12,29,52,76,81,80,32
"l/leuerjo01","Jon Leuer",824,301,286,-15,244,228,29,21,28,37,87,122,157,106,59
"l/lillada01","Damian Lillard",2925,1524,1698,174,788,788,572,588,164,322,387,496,401,292,398
"l/linje01","Jeremy Lin",1907,783,830,47,479,424,176,195,128,211,184,222,295,202,268
"l/livinsh01","Shaun Livingston",1468,437,460,23,394,396,2,0,41,64,107,150,287,246,91
"l/lopezbr01","Brook Lopez",2100,1100,1235,135,977,1010,10,3,113,222,308,404,669,606,274
"l/lopezro01","Robin Lopez",1638,492,566,74,436,468,1,0,55,98,237,308,199,160,127
"l/loveke01","Kevin Love",2532,1098,1226,128,560,538,392,432,146,256,203,248,357,290,321
"l/lowryky01","Kyle Lowry",2414,1179,1239,60,651,596,391,396,137,247,210,264,441,332,312
"l/lucasjo02","John Lucas III",272,106,98,-8,75,66,29,27,2,5,8,8,67,58,5
"m/macksh01","Shelvin Mack",833,305,296,-9,165,154,127,120,13,22,58,66,107,88,31
"m/mahinia01","Ian Mahinmi",1146,253,263,10,211,232,0,0,42,31,123,170,88,62,101
"m/marblde01","Devyn Marble",208,51,37,-14,22,20,22,12,7,5,12,8,10,12,16
"m/mariosh01","Shawn Marion",1101,283,276,-7,221,214,46,36,16,26,108,132,113,82,34
"m/marshke01","Kendall Marshall",417,104,118,14,55,56,46,54,3,8,22,30,33,26,9
"m/martica01","Cartier Martin",198,53,36,-17,20,18,33,18,0,0,5,6,15,12,0
"m/martike01","Kenyon Martin",104,23,20,-3,22,18,0,0,1,2,11,10,11,8,2
"m/martike02","Kevin Martin",1302,707,768,61,433,386,192,225,82,157,63,82,370,304,193
"m/matthwe02","Wesley Matthews",2024,815,955,140,307,328,446,519,62,108,110,132,197,196,145
"m/maxieja01","Jason Maxiell",878,225,203,-22,192,162,0,0,33,41,67,74,125,88,71
"m/mayooj01","O.J. Mayo",1697,758,802,44,424,394,276,297,58,111,138,174,286,220,139
"m/mbahalu01","Luc Mbah a Moute",1916,711,660,-51,434,378,202,186,75,96,194,218,240,160,163
"m/mcadoja01","James Michael McAdoo",137,54,62,8,44,48,0,0,10,14,31,44,13,4,25
"m/mccalra01","Ray McCallum",1436,510,503,-7,359,344,111,102,40,57,146,186,213,158,84
"m/mccolcj01","CJ McCollum",973,395,424,29,226,208,139,165,30,51,77,86,149,122,73
"m/mcdankj01","K.J. McDaniels",1352,495,487,-8,284,258,150,129,61,100,163,188,121,70,133
"m/mcdankj01","K.J. McDaniels",1319,495,487,-8,284,258,150,129,61,100,163,188,121,70,133
"m/mcderdo01","Doug McDermott",321,113,109,-4,66,60,41,39,6,10,43,48,23,12,15
"m/mcgarmi01","Mitch McGary",485,182,201,19,163,176,2,0,17,25,92,126,71,50,40
"m/mcgeeja01","JaVale McGee",256,95,106,11,79,84,0,0,16,22,44,64,35,20,33
"m/mcgeeja01","JaVale McGee",195,95,106,11,79,84,0,0,16,22,44,64,35,20,33
"m/mclembe01","Ben McLemore",2670,899,992,93,440,446,391,420,68,126,179,256,261,190,160
"m/mcrobjo01","Josh McRoberts",296,59,72,13,34,40,19,24,6,8,22,30,12,10,13
"m/meeksjo01","Jodie Meeks",1462,601,660,59,322,296,212,222,67,142,101,124,221,172,160
"m/middlkh01","Khris Middleton",2378,934,1046,112,601,594,268,327,65,125,153,190,448,404,156
"m/milescj01","C.J. Miles",1841,894,936,42,381,350,446,462,67,124,117,152,264,198,161
"m/millean02","Andre Miller",1253,327,355,28,256,276,34,21,37,58,105,132,151,144,77
"m/millean02","Andre Miller",631,327,355,28,256,276,34,21,37,58,105,132,151,144,77
"m/millean02","Andre Miller",622,327,355,28,256,276,34,21,37,58,105,132,151,144,77
"m/millemi01","Mike Miller",701,116,109,-7,16,10,98,96,2,3,2,4,14,6,4
"m/millequ01","Quincy Miller",119,43,29,-14,20,12,18,9,5,8,7,4,13,8,11
"m/millspa02","Patty Mills",801,353,349,-4,154,132,182,186,17,31,41,46,113,86,40
"m/millsel01","Elijah Millsap",924,278,248,-30,148,106,90,84,40,58,75,70,73,36,86
"m/millspa01","Paul Millsap",2390,1082,1218,136,714,732,216,231,152,255,349,448,365,284,337
"m/mirotni01","Nikola Mirotic",1654,751,833,82,311,308,313,297,127,228,165,214,146,94,284
"m/mohamna01","Nazr Mohammed",128,30,25,-5,29,24,0,0,1,1,12,16,17,8,3
"m/monrogr01","Greg Monroe",2137,1004,1098,94,853,846,0,0,151,252,453,556,400,290,336
"m/mooreet01","E'Twaun Moore",504,149,149,0,101,98,38,39,10,12,28,34,73,64,20
"m/morrida01","Darius Morris",299,109,83,-26,73,58,33,21,3,4,33,36,40,22,9
"m/morrima03","Marcus Morris",2045,815,845,30,450,438,313,336,52,71,118,140,332,298,113
"m/morrima02","Markieff Morris",2581,1201,1257,56,921,910,179,171,101,176,252,308,669,602,232
"m/morroan01","Anthony Morrow",1806,648,785,137,289,288,325,423,34,74,54,68,235,220,89
"m/motiedo01","Donatas Motiejunas",2037,776,855,79,567,608,133,147,76,100,196,252,371,356,166
"m/mozgoti01","Timofey Mozgov",2045,666,784,118,560,624,6,6,100,154,338,468,222,156,216
"m/mozgoti01","Timofey Mozgov",897,666,784,118,560,624,6,6,100,154,338,468,222,156,216
"m/mozgoti01","Timofey Mozgov",1148,666,784,118,560,624,6,6,100,154,338,468,222,156,216
"m/muhamsh01","Shabazz Muhammad",866,459,512,53,346,348,51,60,62,104,145,196,201,152,145
"m/muscami01","Mike Muscala",502,162,197,35,129,148,22,27,11,22,55,74,74,74,25
"n/napiesh01","Shabazz Napier",1012,256,263,7,111,90,118,129,27,44,36,34,75,56,56
"n/nealga01","Gary Neal",1193,558,532,-26,339,276,164,150,55,106,55,40,284,236,135
"n/nealga01","Gary Neal",931,558,532,-26,339,276,164,150,55,106,55,40,284,236,135
"n/nealga01","Gary Neal",262,558,532,-26,339,276,164,150,55,106,55,40,284,236,135
"n/nelsoja01","Jameer Nelson",1407,519,523,4,246,232,258,267,15,24,75,104,171,128,36
"n/nelsoja01","Jameer Nelson",584,519,523,4,246,232,258,267,15,24,75,104,171,128,36
"n/nelsoja01","Jameer Nelson",121,519,523,4,246,232,258,267,15,24,75,104,171,128,36
"n/nelsoja01","Jameer Nelson",702,519,523,4,246,232,258,267,15,24,75,104,171,128,36
"n/nichoan01","Andrew Nicholson",492,201,194,-7,149,140,41,39,11,15,28,42,121,98,25
"n/noahjo01","Joakim Noah",2049,509,485,-24,425,380,2,0,82,105,265,268,160,112,174
"n/noelne01","Nerlens Noel",2311,758,744,-14,653,604,0,0,105,140,302,400,351,204,230
"n/novakst01","Steve Novak",197,57,63,6,8,6,48,57,1,0,0,0,8,6,2
"n/novakst01","Steve Novak",109,57,63,6,8,6,48,57,1,0,0,0,8,6,2
"n/nowitdi01","Dirk Nowitzki",2282,1189,1321,132,788,766,274,312,127,243,70,98,718,668,289
"n/nurkiju01","Jusuf Nurkic",1103,445,426,-19,381,342,2,0,62,84,186,214,195,128,132
"o/obryajo01","Johnny O'Bryant",368,131,100,-31,120,88,0,0,11,12,35,38,85,50,27
"o/oquinky01","Kyle O'Quinn",824,267,294,27,199,214,43,36,25,44,69,106,130,108,57
"o/oladivi01","Victor Oladipo",2573,1234,1289,55,838,778,248,252,148,259,460,522,378,256,320
"o/olynyke01","Kelly Olynyk",1423,594,656,62,353,380,175,183,66,93,188,256,165,124,136
"p/pachuza01","Zaza Pachulia",1730,601,606,5,526,480,3,0,72,126,226,252,300,228,160
"p/papanko01","Kostas Papanikolaou",795,205,182,-23,91,76,106,93,8,13,54,60,37,16,18
"p/parkeja01","Jabari Parker",738,293,308,15,247,250,16,12,30,46,113,162,134,88,66
"p/parketo01","Tony Parker",1953,902,971,69,743,732,89,114,70,125,212,254,531,478,166
"p/parsoch01","Chandler Parsons",2186,910,1037,127,482,502,347,396,81,139,262,332,220,170,193
"p/pattepa01","Patrick Patterson",2156,571,648,77,252,270,283,315,36,63,85,94,167,176,80
"p/paulch01","Chris Paul",2857,1316,1552,236,821,858,350,417,145,277,112,142,709,716,321
"p/paynead01","Adreian Payne",739,242,213,-29,211,180,9,3,22,30,58,60,153,120,46
"p/paynead01","Adreian Payne",720,242,213,-29,211,180,9,3,22,30,58,60,153,120,46
"p/paytoel01","Elfrid Payton",2489,804,731,-73,665,580,42,33,97,118,324,334,341,246,214
"p/pekovni01","Nikola Pekovic",815,386,386,0,328,278,0,0,58,108,152,166,176,112,129
"p/perkike01","Kendrick Perkins",1148,264,246,-18,226,204,1,0,37,42,91,110,135,94,83
"p/perkike01","Kendrick Perkins",981,264,246,-18,226,204,1,0,37,42,91,110,135,94,83
"p/perkike01","Kendrick Perkins",167,264,246,-18,226,204,1,0,37,42,91,110,135,94,83
"p/piercpa01","Paul Pierce",1914,751,868,117,353,350,303,354,95,164,129,160,224,190,210
"p/plumlma01","Mason Plumlee",1743,629,717,88,486,560,3,0,140,157,364,470,122,90,317
"p/plumlmi01","Miles Plumlee",1194,276,294,18,254,272,0,0,22,22,155,198,99,74,46
"p/plumlmi01","Miles Plumlee",1005,276,294,18,254,272,0,0,22,22,155,198,99,74,46
"p/plumlmi01","Miles Plumlee",189,276,294,18,254,272,0,0,22,22,155,198,99,74,46
"p/pondequ01","Quincy Pondexter",1793,488,538,50,203,194,244,273,41,71,108,126,95,68,96
"p/pondequ01","Quincy Pondexter",540,488,538,50,203,194,244,273,41,71,108,126,95,68,96
"p/pondequ01","Quincy Pondexter",1253,488,538,50,203,194,244,273,41,71,108,126,95,68,96
"p/porteot01","Otto Porter",1432,426,444,18,287,282,104,105,35,57,89,132,198,150,79
"p/poweldw01","Dwight Powell",236,83,90,7,56,56,11,9,16,25,24,34,32,22,33
"p/poweldw01","Dwight Powell",227,83,90,7,56,56,11,9,16,25,24,34,32,22,33
"p/pressph01","Phil Pressey",600,197,177,-20,109,96,65,48,23,33,57,56,52,40,49
"p/priceaj01","A.J. Price",324,147,133,-14,80,72,57,45,10,16,6,4,74,68,24
"p/priceaj01","A.J. Price",193,147,133,-14,80,72,57,45,10,16,6,4,74,68,24
"p/pricero01","Ronnie Price",982,244,221,-23,114,92,109,93,21,36,44,54,70,38,45
"p/prigipa01","Pablo Prigioni",1197,247,271,24,62,68,166,171,19,32,27,34,35,34,41
"p/prigipa01","Pablo Prigioni",795,247,271,24,62,68,166,171,19,32,27,34,35,34,41
"p/prigipa01","Pablo Prigioni",402,247,271,24,62,68,166,171,19,32,27,34,35,34,41
"p/princta01","Tayshaun Prince",1397,432,433,1,335,292,67,93,30,48,71,84,264,208,65
"p/princta01","Tayshaun Prince",628,432,433,1,335,292,67,93,30,48,71,84,264,208,65
"p/princta01","Tayshaun Prince",198,432,433,1,335,292,67,93,30,48,71,84,264,208,65
"p/princta01","Tayshaun Prince",571,432,433,1,335,292,67,93,30,48,71,84,264,208,65
"r/randosh01","Shavlik Randolph",126,40,24,-16,30,18,5,0,5,6,10,10,20,8,12
"r/randosh01","Shavlik Randolph",101,40,24,-16,30,18,5,0,5,6,10,10,20,8,12
"r/randoza01","Zach Randolph",2304,1064,1143,79,912,894,20,21,132,228,381,492,531,402,298
"r/redicjj01","J.J. Redick",2409,1010,1248,238,480,494,458,600,72,154,85,106,395,388,203
"r/richaja01","Jason Richardson",416,187,169,-18,82,62,96,93,9,14,29,28,53,34,22
"r/ridnolu01","Luke Ridnour",683,185,186,1,113,110,63,60,9,16,15,14,98,96,21
"r/riverau01","Austin Rivers",1563,554,530,-24,365,328,131,117,58,85,144,170,221,158,126
"r/riverau01","Austin Rivers",772,554,530,-24,365,328,131,117,58,85,144,170,221,158,126
"r/riverau01","Austin Rivers",791,554,530,-24,365,328,131,117,58,85,144,170,221,158,126
"r/roberan03","Andre Roberson",1286,224,228,4,116,142,85,63,23,23,102,136,14,6,48
"r/roberbr01","Brian Roberts",1330,483,475,-8,259,228,193,186,31,61,46,48,213,180,74
"r/robingl02","Glenn Robinson",261,79,73,-6,48,42,19,15,12,16,17,24,31,18,24
"r/robingl02","Glenn Robinson",108,79,73,-6,48,42,19,15,12,16,17,24,31,18,24
"r/robingl02","Glenn Robinson",153,79,73,-6,48,42,19,15,12,16,17,24,31,18,24
"r/robinna01","Nate Robinson",591,272,233,-39,143,114,112,93,17,26,39,40,104,74,46
"r/robinna01","Nate Robinson",465,272,233,-39,143,114,112,93,17,26,39,40,104,74,46
"r/robinna01","Nate Robinson",126,272,233,-39,143,114,112,93,17,26,39,40,104,74,46
"r/robinth01","Thomas Robinson",798,308,308,0,258,252,2,0,48,56,147,174,111,78,106
"r/robinth01","Thomas Robinson",391,308,308,0,258,252,2,0,48,56,147,174,111,78,106
"r/robinth01","Thomas Robinson",407,308,308,0,258,252,2,0,48,56,147,174,111,78,106
"r/rondora01","Rajon Rondo",2018,680,608,-72,559,496,86,81,35,31,199,252,360,244,78
"r/rondora01","Rajon Rondo",699,680,608,-72,559,496,86,81,35,31,199,252,360,244,78
"r/rondora01","Rajon Rondo",1319,680,608,-72,559,496,86,81,35,31,199,252,360,244,78
"r/rosede01","Derrick Rose",1530,917,901,-16,564,524,271,228,82,149,219,242,345,282,187
"r/rosste01","Terrence Ross",2092,776,807,31,363,328,390,435,23,44,101,118,262,210,56
"r/rubiori01","Ricky Rubio",692,252,225,-27,168,130,51,39,33,56,39,26,129,104,71
"r/rudezda01","Damjan Rudez",1047,272,320,48,93,100,170,207,9,13,25,32,68,68,23
"r/rushbr01","Brandon Rush",271,59,30,-29,27,16,27,9,5,5,9,6,18,10,11
"s/sacrero01","Robert Sacre",1133,346,307,-39,305,252,1,0,40,55,48,62,257,190,82
"s/salmojo01","John Salmons",270,50,42,-8,22,16,26,24,2,2,2,2,20,14,4
"s/sampsja02","JaKarr Sampson",1131,390,386,-4,220,230,126,93,44,63,129,166,91,64,94
"s/sandela01","Larry Sanders",586,193,196,3,172,172,0,0,21,24,126,146,46,26,48
"s/schrode01","Dennis Schroder",1516,748,766,18,517,464,148,156,83,146,253,276,264,188,179
"s/scolalu01","Luis Scola",1659,741,761,20,621,588,20,15,100,158,241,294,380,294,226
"s/scottmi01","Mike Scott",1123,488,528,40,261,270,192,198,35,60,83,116,178,154,77
"s/sefolth01","Thabo Sefolosha",976,274,278,4,170,158,78,75,26,45,104,118,66,40,58
"s/serapke01","Kevin Seraphin",1235,484,520,36,448,462,2,0,34,58,107,150,341,312,82
"s/sessira01","Ramon Sessions",1188,412,402,-10,274,212,60,57,78,133,103,108,171,104,173
"s/sessira01","Ramon Sessions",642,412,402,-10,274,212,60,57,78,133,103,108,171,104,173
"s/sessira01","Ramon Sessions",546,412,402,-10,274,212,60,57,78,133,103,108,171,104,173
"s/shumpim01","Iman Shumpert",1545,499,496,-3,275,252,196,201,28,43,88,100,187,152,64
"s/shumpim01","Iman Shumpert",625,499,496,-3,275,252,196,201,28,43,88,100,187,152,64
"s/shumpim01","Iman Shumpert",920,499,496,-3,275,252,196,201,28,43,88,100,187,152,64
"s/shvedal01","Alexey Shved",767,402,433,31,196,172,139,141,67,120,112,132,84,40,150
"s/shvedal01","Alexey Shved",285,402,433,31,196,172,139,141,67,120,112,132,84,40,150
"s/shvedal01","Alexey Shved",423,402,433,31,196,172,139,141,67,120,112,132,84,40,150
"s/simshe01","Henry Sims",1399,559,576,17,480,468,22,12,57,96,159,198,321,270,137
"s/singlky01","Kyle Singler",1743,470,480,10,205,152,241,288,24,40,68,80,137,72,52
"s/singlky01","Kyle Singler",1287,470,480,10,205,152,241,288,24,40,68,80,137,72,52
"s/singlky01","Kyle Singler",456,470,480,10,205,152,241,288,24,40,68,80,137,72,52
"s/sloando01","Donald Sloan",1107,390,393,3,225,210,131,123,34,60,103,122,122,88,77
"s/smartma01","Marcus Smart",1808,532,523,-9,205,168,272,273,55,82,84,94,121,74,127
"s/smithgr02","Greg Smith",363,68,80,12,49,60,0,0,19,20,40,50,9,10,39
"s/smithis01","Ish Smith",832,392,338,-54,307,250,60,54,25,34,118,130,189,120,57
"s/smithis01","Ish Smith",155,392,338,-54,307,250,60,54,25,34,118,130,189,120,57
"s/smithis01","Ish Smith",677,392,338,-54,307,250,60,54,25,34,118,130,189,120,57
"s/smithjr01","J.R. Smith",2080,787,847,60,329,304,426,489,32,54,80,90,249,214,72
"s/smithjr01","J.R. Smith",619,787,847,60,329,304,426,489,32,54,80,90,249,214,72
"s/smithjr01","J.R. Smith",1461,787,847,60,329,304,426,489,32,54,80,90,249,214,72
"s/smithja02","Jason Smith",1785,665,656,-9,550,484,42,45,73,127,85,82,465,402,153
"s/smithjo03","Josh Smith",2300,1105,1027,-78,759,684,228,216,118,127,293,372,466,312,255
"s/smithjo03","Josh Smith",896,1105,1027,-78,759,684,228,216,118,127,293,372,466,312,255
"s/smithjo03","Josh Smith",1404,1105,1027,-78,759,684,228,216,118,127,293,372,466,312,255
"s/snellto01","Tony Snell",1412,395,434,39,174,172,197,219,24,43,84,112,90,60,55
"s/speigma01","Marreese Speights",1207,728,790,62,628,626,18,15,82,149,204,258,424,368,178
"s/splitti01","Tiago Splitter",1030,357,428,71,303,338,0,0,54,90,189,226,114,112,120
"s/stausni01","Nik Stauskas",1127,325,318,-7,147,120,149,144,29,54,52,56,95,64,64
"s/stephla01","Lance Stephenson",1573,593,501,-92,445,378,105,54,43,69,162,184,283,194,110
"s/stokeja01","Jarnell Stokes",126,50,57,7,37,42,0,0,13,15,26,34,11,8,28
"s/stoudam01","Amar'e Stoudemire",1245,570,680,110,486,546,4,0,80,134,252,346,234,200,186
"s/stoudam01","Amar'e Stoudemire",865,570,680,110,486,546,4,0,80,134,252,346,234,200,186
"s/stoudam01","Amar'e Stoudemire",380,570,680,110,486,546,4,0,80,134,252,346,234,200,186
"s/stuckro01","Rodney Stuckey",1874,846,894,48,613,554,141,165,92,175,194,222,419,332,216
"s/sullija01","Jared Sullinger",1566,764,770,6,523,518,184,156,57,96,190,238,333,280,129
"t/tayloje03","Jeffery Taylor",430,132,127,-5,78,68,36,33,18,26,35,46,43,22,41
"t/teaguje01","Jeff Teague",2228,1033,1153,120,680,674,207,213,146,266,323,400,357,274,319
"t/teletmi01","Mirza Teletovic",892,340,339,-1,126,120,193,186,21,33,64,68,62,52,46
"t/telfase01","Sebastian Telfair",327,138,130,-8,65,56,59,51,14,23,25,20,40,36,34
"t/templga01","Garrett Temple",735,193,204,11,82,70,88,99,23,35,37,44,45,26,48
"t/terryja01","Jason Terry",1641,461,533,72,123,124,323,378,15,31,31,34,92,90,48
"t/thomais02","Isaiah Thomas",1726,950,1091,141,451,412,346,387,153,292,202,236,249,176,348
"t/thomais02","Isaiah Thomas",1181,950,1091,141,451,412,346,387,153,292,202,236,249,176,348
"t/thomais02","Isaiah Thomas",545,950,1091,141,451,412,346,387,153,292,202,236,249,176,348
"t/thomala01","Lance Thomas",1490,487,443,-44,420,350,22,21,45,72,96,114,324,236,99
"t/thomala01","Lance Thomas",450,487,443,-44,420,350,22,21,45,72,96,114,324,236,99
"t/thomala01","Lance Thomas",1040,487,443,-44,420,350,22,21,45,72,96,114,324,236,99
"t/thomama01","Malcolm Thomas",194,46,45,-1,33,36,7,0,6,9,20,30,13,6,13
"t/thompho01","Hollis Thompson",1776,577,624,47,256,218,287,345,34,61,95,110,161,108,89
"t/thompja02","Jason Thompson",1991,496,491,-5,427,402,1,0,68,89,134,162,293,240,143
"t/thompkl01","Klay Thompson",2455,1410,1661,251,754,726,545,717,111,218,223,304,531,422,256
"t/thomptr01","Tristan Thompson",2194,603,693,90,488,534,0,0,115,159,325,420,163,114,248
"t/thornma01","Marcus Thornton",721,364,370,6,202,172,143,162,19,36,77,76,125,96,56
"t/thornma01","Marcus Thornton",640,364,370,6,202,172,143,162,19,36,77,76,125,96,56
"t/tollian01","Anthony Tolliver",1432,423,482,59,103,110,290,318,30,54,60,78,43,32,69
"t/tollian01","Anthony Tolliver",272,423,482,59,103,110,290,318,30,54,60,78,43,32,69
"t/tollian01","Anthony Tolliver",1160,423,482,59,103,110,290,318,30,54,60,78,43,32,69
"t/tuckepj01","P.J. Tucker",2383,662,712,50,344,348,252,261,66,103,159,216,185,132,143
"t/turkohe01","Hedo Turkoglu",705,193,232,39,49,46,139,180,5,6,14,20,35,26,11
"t/turneev01","Evan Turner",2260,812,779,-33,627,574,119,99,66,106,185,216,442,358,141
"u/udohek01","Ekpe Udoh",128,28,29,1,24,22,0,0,4,7,5,8,19,14,9
"u/udrihbe01","Beno Udrih",1494,548,602,54,408,440,97,78,43,84,106,144,302,296,102
"v/valanjo01","Jonas Valanciunas",2096,782,963,181,651,746,1,0,130,217,329,440,322,306,276
"v/varejan01","Anderson Varejao",636,221,255,34,198,222,2,0,21,33,91,122,107,100,45
"v/vasqugr01","Greivis Vasquez",1991,752,774,22,374,326,351,399,27,49,81,92,293,234,66
"v/villach01","Charlie Villanueva",678,379,403,24,141,134,221,249,17,20,57,60,84,74,35
"v/vonleno01","Noah Vonleh",259,89,83,-6,63,50,13,15,13,18,34,32,29,18,26
"v/vucevni01","Nikola Vucevic",2529,1301,1428,127,1200,1258,6,6,95,164,372,494,828,764,218
"w/wadedw01","Dwyane Wade",1971,1246,1321,75,982,960,102,87,162,274,249,340,733,620,370
"w/waitedi01","Dion Waiters",2208,1023,940,-83,700,604,246,219,77,117,317,322,383,282,172
"w/waitedi01","Dion Waiters",786,1023,940,-83,700,604,246,219,77,117,317,322,383,282,172
"w/waitedi01","Dion Waiters",1422,1023,940,-83,700,604,246,219,77,117,317,322,383,282,172
"w/walkebi01","Henry Walker",628,175,175,0,36,26,131,135,8,14,18,20,18,6,18
"w/walkeke02","Kemba Walker",2119,1096,1059,-37,701,586,280,255,115,218,253,250,448,336,283
"w/walljo01","John Wall",2837,1323,1379,56,948,906,217,195,158,278,335,412,613,494,362
"w/wallage01","Gerald Wallace",286,41,35,-6,31,26,3,3,7,6,24,22,7,4,15
"w/warretj01","T.J. Warren",614,220,245,25,193,216,21,15,6,14,95,134,98,82,19
"w/watsocj01","C.J. Watson",1422,488,561,73,242,222,175,210,71,129,74,90,168,132,167
"w/weartr01","Travis Wear",672,221,199,-22,179,146,30,33,12,20,26,20,153,126,26
"w/webstma02","Martell Webster",352,119,106,-13,48,28,42,30,29,48,15,12,33,16,64
"w/westda01","David West",1895,761,769,8,666,638,20,12,75,119,109,140,557,498,161
"w/westbru01","Russell Westbrook",2302,1759,1869,110,1183,1082,288,258,288,529,513,594,670,488,654
"w/whiteha01","Hassan Whiteside",1142,454,564,110,387,486,0,0,67,78,205,312,182,174,156
"w/whittsh01","Shayne Whittington",108,53,57,4,36,36,6,3,11,18,13,16,23,20,23
"w/wiggian01","Andrew Wiggins",2969,1351,1387,36,1014,916,126,117,211,354,356,470,658,446,466
"w/wilcocj01","C.J. Wilcox",101,38,41,3,19,18,19,21,0,2,5,8,14,10,2
"w/willide01","Deron Williams",2114,875,873,-2,535,424,237,261,103,188,162,148,373,276,241
"w/willide02","Derrick Williams",1462,573,617,44,329,336,156,147,88,134,166,228,163,108,196
"w/williel01","Elliot Williams",119,39,37,-2,19,12,18,24,2,1,7,8,12,4,4
"w/willilo02","Lou Williams",2016,1087,1237,150,481,446,447,456,159,335,104,110,377,336,395
"w/willima02","Marvin Williams",2035,535,579,44,231,232,265,285,39,62,77,106,154,126,87
"w/willima01","Mo Williams",1980,934,947,13,512,444,348,357,74,146,58,56,454,388,187
"w/willima01","Mo Williams",1149,934,947,13,512,444,348,357,74,146,58,56,454,388,187
"w/willima01","Mo Williams",831,934,947,13,512,444,348,357,74,146,58,56,454,388,187
"w/willire02","Reggie Williams",105,40,37,-3,20,24,19,9,1,4,10,14,10,10,4
"w/willish03","Shawne Williams",1087,319,340,21,122,114,178,192,19,34,47,48,75,66,40
"w/willish03","Shawne Williams",924,319,340,21,122,114,178,192,19,34,47,48,75,66,40
"w/willish03","Shawne Williams",163,319,340,21,122,114,178,192,19,34,47,48,75,66,40
"w/witheje01","Jeff Withey",259,88,98,10,64,64,0,0,24,34,36,44,28,20,50
"w/woltena01","Nate Wolters",247,59,42,-17,50,40,7,0,2,2,19,20,31,20,6
"w/woltena01","Nate Wolters",142,59,42,-17,50,40,7,0,2,2,19,20,31,20,6
"w/woltena01","Nate Wolters",105,59,42,-17,50,40,7,0,2,2,19,20,31,20,6
"w/wrighbr03","Brandan Wright",1449,411,544,133,360,466,3,0,48,78,215,336,145,130,112
"w/wrighbr03","Brandan Wright",505,411,544,133,360,466,3,0,48,78,215,336,145,130,112
"w/wrighbr03","Brandan Wright",858,411,544,133,360,466,3,0,48,78,215,336,145,130,112
"w/wrighdo01","Dorell Wright",592,207,219,12,82,62,108,123,17,34,30,36,52,26,42
"w/wroteto01","Tony Wroten",895,514,507,-7,292,276,142,111,80,120,220,244,72,32,180
"y/youngja01","James Young",332,115,105,-10,36,38,66,51,13,16,10,16,26,22,29
"y/youngni01","Nick Young",1000,531,556,25,251,182,225,249,55,125,48,60,203,122,148
"y/youngth01","Thaddeus Young",2434,1059,1069,10,851,824,115,114,93,131,385,476,466,348,200
"y/youngth01","Thaddeus Young",1605,1059,1069,10,851,824,115,114,93,131,385,476,466,348,200
"y/youngth01","Thaddeus Young",829,1059,1069,10,851,824,115,114,93,131,385,476,466,348,200
"z/zelleco01","Cody Zeller",1487,449,472,23,372,342,1,3,76,127,190,218,182,124,164
"z/zellety01","Tyler Zeller",1731,700,833,133,617,680,0,0,83,153,285,360,332,320,186
